dwarka is also a dhaam among the chaar dhaams                                                                                                                                                                                                                	द्वारका चार धामों में एक धाम भी है
lord krishna had specially settled this amidst the sea 	भगवान कृष्ण ने इसे समुद्र के बीच में विशेष रूप से बसाया था
situated on the western railway s surendranagarokha port line this city is a coastal station	पश्चिम रेलवे की सुरेंद्रनगरओखा पोर्ट लाइन पर स्थित यह नगर समुद्र किनारे का स्टेशन है
this holy city is mathura the avatar land of lord shrikrishna on the banks of the yamuna	यमुना तट पर भगवान श्रीकृष्ण की अवतार भूमि का यह पवित्र नगर मथुरा है
mathura station is on the northeastern railway s line going to gorakhpur from agra fort and on the western railway s mumbaikotadelhi line	पूर्वोत्तर रेलवे की आगरा फोर्ट से गोरखपुर जाने वाली लाइन तथा पश्चिम रेलवे की मुंबईकोटादिल्ली लाइन पर मथुरा स्टेशन है
garhmukteshwar is a sacred pilgrimage of the hindus	गढ़मुक्तेश्वर हिंदुओं का पावन तीर्थ है
let us go to the ganges fair of garh mukteshwar	चलें गढ़ मुक्तेश्वर का गंगा मेला
the history of north india s famous and ancient religious fair held every year on the occasion of kartik poornima on the banks of the fallen purgator ganges in the garh mukteshwar of ghaziabad district	गाजियाबाद जिले के गढ़ मुक्तेश्वर में पतित पावनी गंगा के तट पर हर साल कार्तिक पूर्णिमा के अवसर पर लगने वाले उत्तर भारत के प्रसिद्ध और प्राचीन धार्मिक मेले का इतिहास लगभग पाँच हजार वर्ष पुराना है
there is full fervor of the fair this time also in garh mukteshwar and huge crowd of devotees is gathering for the holy dip	इस बार भी गढ़ मुक्तेश्वर में मेले की भरपूर गहमागहमी है और मुख्य स्नान के लिए श्रद्धालुओं की भारी भीड़ जुट रही है
the holy dip is on november	मुख्य स्नान नवंबर को है
it is said about garh mukteshwar that on looking at the detriments of the war and genocide after the disastrous war of the mahabharata yogiraj krishna dharmaraja yudhisthir and arjun regretted hugely	गढ़ मुक्तेश्वर के विषय में कहा जाता है कि महाभारत के विनाशकारी युद्ध के बाद योगीराज श्रीकृष्ण धर्मराज युधिष्ठिर व अर्जुन के मन में युद्ध की विभीषिका और नरसंहार को देखकर भारी ग्लानि हुई
they began thinking as to what should be done for the peace of the innumerable relatives colleagues and innocent people killed in the war	वे इस सोच में पड़ गए कि युद्ध में मारे गए असंख्य कुटुम्बियों बंधुओं व निर्दोष लोगों की आत्मा की शांति के लिए क्या उपाय या संस्कार किया जाए
then all decided unanimously	तब सबने एक राय से निर्णय लिया था
all the sanskars will get completed with worship of the mukteshwar mahadev at a place called shiv ballabhapur established by lord parashuram in khandavi forest yajna and a bath at the fallen purgator ganges and offering a pindadan there	खांडवी वन में भगवान परशुराम द्वारा स्थापित शिव बल्लभपुर नामक स्थान पर मुक्तेश्वर महादेव की पूजा यज्ञ तथा पतित पावनी गंगा में स्नान करने और वहाँ पिंडदान करने से सभी संस्कार पूर्ण हो जाएँगे
it is to be noted that it is shiv ballabhpur that is known as garh mukteshwar now	ज्ञात रहे कि शिव बल्लभपुर को ही अब गढ़ मुक्तेश्वर के नाम से जाना जाता है
maharaj shivi the ancestor of lord rama had spent his exile at garh muktesher	भगवान राम के पूर्वज महाराज शिवि ने अपना वानप्रस्थ गढ़ मुक्तेश्वर में ही व्यतीत किया था
maharaj shivi had lord parashuram establish the shiva temple here	महाराज शिव ने भगवान परशुराम से यहाँ शिव मंदिर की स्थापना कराई थी
at that time garh mukteshwar was the main center of ballabh sect	उस समय गढ़ मुक्तेश्वर बल्लभ संप्रदाय का मुख्य केन्द्र था
garh mukteshwar was named as shiv ballabhpur	गढ़ मुक्तेश्वर का नाम शिव बल्लभपुर पड़ा
the description of garh mukteshwar is found in the shiva purana	गढ़ मुक्तेश्वर का वर्णन शिव पुराण में मिलता है
a yajna was conducted from the eleventh day to the fourteenth day of the fortnight in garh mukteshwar for the peace of the souls killed in the war of the mahabharata	एकादशी से चतुर्दशी तक गढ़ मुक्तेश्वर में महाभारत युद्ध में मारे गए सभी लोगों की आत्मा की शांति के लिए यज्ञ किया गया
on the evening of the fourteenth day after the end of the yajna tributes were offered to those souls by offering earthen lamps in the ganges	चतुर्दशी की संध्या को यज्ञ की समाप्ति पर उन आत्माओं को गंगा में दीप दान कर श्रद्धांजलि अर्पित की गई
next day on the full moon morning having bathed in the ganges all offered prayers and religious stories	अगले दिन प्रात पूर्णमासी को सभी ने गंगा स्नान कर पूजाअर्चना कथा आदि की
every year devotees in lacs of numbers come to garh mukteshwar to take a bath in the blemishdestroyer sinpurgator ganges and to offer earthen lamps for the peace of the souls of their kins	प्रत्येक वर्ष लाखों की संख्या में श्रद्धालु गढ़ मुक्तेश्वर कार्तिक पूर्णिमा पर कलुष विनाशनी पापहरिणी गंगा में स्नान करने और अपने स्वजनों की आत्मा की शांति के लिए यहाँ दीप दान करने आते हैं
innumerous people offer earthen lamps in the ganges as tribute to their kins on the evening of the fourteenth day of the fortnight	चतुर्दशी की शाम को असंख्य लोग अपने स्वजनों को श्रद्धांजलि देने के लिए गंगा में दीप दान करते हैं
during that time lamps flowing with the stream of the ganges appear very peace giving and charming	उस वक्त गंगा की धारा के साथ बहते दीपों का दृश्य बड़ा ही शांतिदायक और मनोहारी प्रतीत होता है
there are several places of religious importance in garh mukteshwar such as nahush well the temple of the mukteshwar mahadev the badrinath templeh	गढ़ मुक्तेश्वर में धार्मिक महत्व की कई जगहें हैं जैसे नहुषकूप नक्का कुआँ मुक्तेश्वर महादेव का मंदिर बद्रीनाथ मंदिर आदि
custom is that the badrinath temple is opened during the prayer time only	प्रथा है कि बद्रीनाथ मंदिर को केवल आरती के समय ही खोला जाता है
this temple is opened only once in a year for the whole day during the birth anniversary of parashuram on akshaya tritiya	यह मंदिर साल में केवल एक बार अक्षय तृतीया को परशुराम जयंती पर दिन भर दर्शनार्थियों के लिए खोला जाता है
there is a sand filled field in front of the mukteshwar mahadev temple which is known as meerabai ki reti	मुक्तेश्वर महादेव मंदिर के सामने विशाल रेतीला मैदान है उसे मीराबाई की रेती के नाम से जाना जाता है
it is believed that meerabai had come to bathe here once	ऐसी मान्यता है कि एक बार मीराबाई यहाँ गंगा स्नान के लिए आई थीं
it is said that once parvatiji asked a question to shankarji	कहते हैं कि एक बार पार्वती जी ने शंकर जी से प्रश्न किया
lord advise a solution and place by which a living being gets relieved from several ills and sins	प्रभु ऐसा कोई उपाय और स्थान बताएँ जिससे संसार में अनेक व्याधियों और पापों से त्रस्त जीव को मुक्ति मिले
what should they do so that they get your affection	वे ऐसा क्या कर्म करें जिससे उन्हें आपका स्नेह मिले
on this shankarji said that o devi all the pilgrimages give the fruits of meritorious actions in the satayuga treta in pushkar in dwapar kurukshetra pilgrimage gives the fruits of meritorious actions and in kalikala achievements of the fruits of meritorious actions is only through the ganga bath	इस पर शंकर जी कहा कि हे देवी सतयुग में सभी तीर्थ पुण्य का फल देते हैं त्रेता में पुष्कर द्वापर में कुरुक्षेत्र तीर्थ पुण्य का फल देते हैं और कलिकाल में केवल गंगा स्नान से पुण्य फल की प्राप्ति है
there is a place called shiva ballabhpur on the banks of the ganges	गंगा तट पर शिव बल्लभपुर नामक एक स्थान है
shiva resides in the place called shiva ballabhpur	शिव बल्लभपुर नामक स्थान में शिव निवास करते हैं
shiva ballabhpur is very favorite to shivaji	शिव बल्लभपुर शिवजी को अति प्रिय है
shiva ballabhpur is located in the east direction of hastinapur in the country of aryavarta of jambudweep	शिव बल्लभपुर जम्बूद्वीप के आर्यावर्त देश में हस्तिनापुर की पूर्व दिशा में स्थित है
situated on the banks of the ganges shiva ballabhpur is satisfying to the deities sages and ancestors	गंगा तट पर बसा शिव बल्लभपुर देवों ऋषियों और पितरों को संतोष देने वाला है
shiva ballabhpur area is favorite to me like kashi	शिव बल्लभपुर क्षेत्र मुझे काशी के समान प्रिय है
the ganges temple in garh mukteshwar is built at a very great height	गढ़ मुक्तेश्वर में स्थित गंगा मंदिर काफी ऊँचाई पर बना हुआ है
besides the mother ganges temple there is also a statue of brahmaji installed in garh mukteshwar	गढ़ मुक्तेश्वर के गंगा मंदिर में गंगा मैया के अतिरिक्त ब्रह्मा जी की मूर्ति भी लगी हुई है
there is also such a stone in the ganges temple of garh mukteshwar looking closely at which the shape of lord shiva appears to be on it	गढ़ मुक्तेश्वर के गंगा मंदिर में एक ऐसा पत्थर भी है जिसे ध्यानपूर्वक देखने से उस पर भगवान शिव की आकृति का आभास होता है
at one time there used to be steps to reach the ganga temple of garh mukteshwar	गढ़ मुक्तेश्वर के गंगा मंदिर में पहुँचने के लिए कभी सीढ़ियाँ हुआ करती थीं
but now there are only steps left in the ganges temple of garh mukteshwar	किंतु गढ़ मुक्तेश्वर के गंगा मंदिर में अब सीढ़ियाँ ही बची हैं
it is said that till the ganges used to flow touching the steps of the ganges temple of garh mukteshwar	बताते हैं कि तक गंगा जी गढ़ मुक्तेश्वर के गंगा मंदिर की सीढ़ियों को छूते हुए बहती थीं
but gradually gangaji started leaving the place	लेकिन धीरेधीरे गंगा जी स्थान छोड़ती चली गईं
now the bank of the ganges is about kilometres away from this temple	अब गंगा का तट इस मंदिर से लगभग किलोमीटर दूर है
a fair is organized on the sandy fields of the banks of the ganges	गंगा तट के रेतीले मैदान में मेला लगता है
one whole city of tents gets settled on the banks during the fair	मेले के दौरान तट पर तंबुओं का एक पूरा नगर बस जाता है
the venue of the fair is about kilometres from delhi	मेला स्थल दिल्ली से लगभग किलोमीटर पड़ता है
one can easily reach the fair ground through car etcetera	मेला स्थल कार आदि से आराम से पहुँचा जा सकता है
earlier people had to go on foot to the fair venue in garh mukteshwar	गढ़ मुक्तेश्वर में पहले मेला स्थल तक लोगों को पैदल ही चलकर जाना पड़ता था
but now there are several ways of travel available	लेकिन अब यातायात के कई साधन उपलब्ध हैं
many people reach the fair venue by buggi tractor trollies cars and other resources	अनेक लोग भैंसा बुग्गी ट्रैक्टर ट्रॉलियों कार और अन्य साधनों से मेला स्थल तक पहुँचते हैं
it is estimated that every year about twenty lac people come to garh mukteshwar for holy bath in the ganges during the fair in garh mukteshwar	अनुमान है कि हर साल करीब बीस लाख लोग गढ़ मुक्तेश्वर मेले के दौरान गंगा स्नान करने आते हैं
most of the devotees coming to participate in the fair stay in the tents only	मेले में भाग लेने आए ज्यादातर श्रद्धालु लगाए गए टेंटों में ही ठहरते हैं
apart from the fair people coming during the general days stay in the dharamashalas built around the braj ghat	मेले के अलावा सामान्य दिनों में आने वाले लोग ब्रज घाट के आसपास बनी धर्मशालाओं में ठहरते हैं
as such food items are found in several shops here	यूँ तो यहाँ खानेपीने का सामान बहुत सी दुकानों में मिल जाता है
but devotees coming in the form of groups manage their food etcetera themselves	पर समूह के रूप में मेले में आने वाले श्रद्धालु अपने भोजन आदि की व्यवस्था स्वयं ही करते हैं
the fair organized on the eve of kartik poornima on the banks of the ganges in garh mukteshwar is one of the biggest fairs	कार्तिक पूर्णिमा के अवसर पर गढ़ मुक्तेश्वर में गंगा तट पर लगने वाला मेला विशालतम मेलों में से एक है
fair takes place on the banks of the ganges in an area of about kilometres	मेला गंगा के किनारे लगभग किलोमीटर के क्षेत्र में लगता है
this time the organization of fair is being done by dividing the fair venue into sectors	इस वर्ष मेले का आयोजन मेला स्थल को सेक्टरों में बाँट कर किया जा रहा है
for security reasons more police forces have been deployed in garh mukteshwar than earlier	सुरक्षा के लिहाज से गढ़ मुक्तेश्वर में पहले के मुकाबले पुलिस फोर्स ज्यादा लगाई गई है
close circuit tvs have also been installed at main places	प्रमुख स्थानों पर क्लोज सर्किट टीवी कैमरे भी लगाए गए हैं
several ghats have also been built for the bath in the ganges	गंगा स्नान के लिए अनेक घाट भी बनाए गए हैं
hastinapur has a historical importance	हस्तिनापुर का ऐतिहासिक महत्व है
jain community has special importance for all castes of north india	जैन जगत से उत्तर भारत वर्ष की सम्पूर्ण जातियों के लिए विशेष महत्व है
to go to hastinapur we considered it convenient go from the kashmiri gate bus terminus in delhi	हस्तिनापुर जाने के लिए हमने दिल्ली में कश्मीरी गेट बस अड्डे से जाना सुविधाजनक समझा
buses go continuously for meerut from kashmere gate	कश्मीरी गेट से लगातार मेरठ तक की बसें जाती हैं
then buses are found from meerut to hastinapur	फिर मेरठ से हस्तिनापुर की बसें मिल जाती हैं
the distance from delhi to hastinapur is about kilometres	दिल्ली से हस्तिनापुर की दूरी तकरीबन किलोमीटर है
hastinapur is also known by several other names in the scriptures such as gajpur nagpur asandhivat brahmasthal shantinagar kujarpur etc	हस्तिनापुर को शास्त्रों में अन्य कई नामों से भी जाना जाता है जैसे गजपुर नागपुर असंधिवत ब्रह्मास्थल शांतिनगर कुजारपुर आदि
in hastinapur shree adinath prabhu the first among the twenty four tirthankaras of jainism had ended his four hundred day fast by having juice of sugar cane from shreyansh kumar s hand	हस्तिनापुर में जैन धर्म के चौबीस तीर्थंकरों में सें सबसे पहले तीर्थंकर श्री आदिनाथ प्रभु ने अपने चार सौ दिनों के व्रत के पश्चात श्रेयंषकुमार के हाथों से गन्ने का रस ग्रहण कर अपने व्रत का समापन किया था
it was in hastinapur that twelve kalyanaks of shree shantinath prabhu kunthanath prabhu and shri arahanath prabhu occurred	हस्तिनापुर में ही श्री शांतिनाथ प्रभु कुंथनाथ प्रभु और श्री अरहनाथ प्रभु के बारह कल्याणक हुए
samosaran of bhagwan malliknath also took place in hastinapur	भगवान मल्लिनाथ का समवोशरन भी हस्तिनापुर में ही हुआ
it was in hastinapur that muni suvrat nath swami bhagwan parswanath and bhagwan mahavir swami preached in their divine voice	हस्तिनापुर में ही मुनि सुव्रत नाथ स्वामी भगवान पार्श्वनाथ और भगवान महावीर स्वामी ने अपनी दिव्य वाणी में प्रवचन दिए
the time of ablution and prayer in hastinapur is from oclock in the morning to oclock in the evening	हस्तिनापुर में प्रक्षाल और पूजाअर्चना का समय सुबह बजे से शाम बजे तक है
and the time to pray in digambar jain temple begins from seven oclock in the morning	और दिगम्बर जैन मंदिर में पूजा करने का समय सुबह सात बजे प्रारम्भ होता है
adinath bhagwan came to hastinapur four hundred days after initiation on the third light half month of baisakh	हस्तिनापुर में आदिनाथ भगवान दीक्षा लेने के सौ दिनों बाद वैशाख शुक्ल तृतीया के दिन आए थे
people from afar used to go to visit him	लोगबाग दूरदूर से उनके दर्शन के लिए जाते थे
when the prince shreyanshkumar came to know of this he remembered the tradition of his ancestors to abandon food and water	राजकुमार श्रेयंषकुमार को जब इस बात का ज्ञान हुआ तो उन्हें अपने पूर्वजों की अन्नजल त्यागने की प्रथा का स्मरण हो आया
prince shreyanshkumar urged adinatha prabhu to accept sugar cane juice for ending the fast which he accepted	राजकुमार श्रेयंषकुमार ने आदिनाथ प्रभु से व्रत के समापन के लिए इक्षु रस ग्रहण करने की प्रार्थना की जिसे उन्होंने स्वीकार किया
since then this day has started to be called as akshay tritiya	बाद में इस दिन को अक्षय तृतीया कहा जाने लगा
in hastinapur bhagwan made big kings follower of the jain religion with his preachings	हस्तिनापुर में भगवान ने अपने प्रवचनों से बड़े राजाओं को जैन धर्म का अनुयायी बनाया
out of the tirthankaras the th tirthankar shri sant suvrat swami rd tirthankar parsvanath bhagwan and the last tirthankar mahavir swami purified this place with their holy feet	तीर्थंकरो में से वें तीर्थंकर श्री मुनि सुव्रत स्वामी वें तीर्थंकर पार्श्वनाथ भगवान और अंतिम तीर्थंकर श्री महावीर स्वामी ने भी इस स्थान को अपने चरणों से पावन किया
there have been a total of supreme emperors in india	भारत में कुल चक्रवर्ती सम्राट हुए
the birth place of among the total of supreme emperors of india is hastinapur	भारत के कुल चक्रवर्ती सम्राट में से का जन्म स्थान हस्तिनापुर है
parashuram of the ramayana age was also born in hastinapur	रामायण काल के परशुराम भी हस्तिनापुर में पैदा हुए
hastinapur has been the capital of the kauravas and the pandavas	हस्तिनापुर कौरवों और पांडवों की राजधानी रह चुकी है
functions are organized on kartik full moonlight and third lighted fortnight of vaisakh in shwetambar jain temple and between kartik shukla to full moonlight in digambar jain temple	कार्तिक पूर्णिमा और वैशाख शुक्ल तृतीया को श्वेताम्बर जैन मंदिर में और कार्तिक शुक्ल से पूर्णिमा के बीच दिगम्बर जैन मंदिर में कार्यक्रम का आयोजन किया जाता है
bhagwan adinath had entrusted the states of podanpur and hastinapur to his son bahubali	भगवान आदिनाथ ने पोदनपुर और हस्तिनापुर राज्य अपने पुत्र बाहुबली को सौंप दिये थे
bahubali ruled podanpur	बाहुबली ने पोदनपुर पर शासन किया
while his son ruled hastinapur	जबकि उनके पुत्र सोमयश ने हस्तिनापुर पर
the younger brother of bahubali shreyansh kumar had performed the feet worship of adinath bhagwan	बाहुबली के छोटे भाई श्रेयंषकुमार ने आदिनाथ भगवान का चरणाभिषेक किया था
ratna stambha was built in the memory of shreyansh kumar	श्रेयंषकुमार की स्मृति में रत्न स्तम्भ बनवाया था
the charanpaduka of adinath bhagwan was also installed there	वहाँ पर आदिनाथ भगवान के चरणपादुका भी स्थापित किये थे
three pillars were also built in the memory of the four kalyanakas of shri shantinatha shri kunthanatha and arahanath bhagawana	श्री शांतिनाथ भगवान श्री कुंथनाथ भगवान और अरहनाथ भगवान के चार कल्याणक की स्मृति में भी यहाँ तीन स्तम्भ बनवाये गए
king shivraj adopted jainism after listening to the preachings of mahavir swami king shivraj built a pillar in hastinapur in the memory of mahavir swami	राजा शिवराज ने महावीर स्वामी के प्रवचन सुनकर जैन धर्म को अपनाया महावीर स्वामी की स्मृति में राजा शिवराज ने हस्तिनापुर में एक स्तम्भ बनवाया
a descendant of the emperor ashoka also got many jain temples made during his regime	सम्राट अशोक के एक वंशज ने भी अपने शासन काल के दौरान कई जैन मंदिर बनवाए
but with time those ancient pillars and temples have vanished	लेकिन समय के साथ वे प्राचीन स्तम्भ और मंदिर धीरेधीरे विलीन हो गए
this hastinapur nagar is present on the banks of the ganges	यह हस्तिनापुर नगर पवित्र गंगा के किनारे मौजूद है
management of dharamshala is also found for the stay of the people reaching hastinapur	हस्तिनापुर पहुँचे लोगों के ठहरने के लिए धर्मशाला का भी प्रबंध मिलता है
in shwetambar trust dharamshala there are rooms to stay with morning breakfast afternoon lunch and dinner at night	श्वेतांबर ट्रस्ट धर्मशाला में ठहरने के लिए कमरे और सुबह का नाश्ता दोपहर का लंच और रात के भोजन की व्यवस्था होती है
there are several other dharamashalas found easily in the same fashion	इसी प्रकार अन्य कईं धर्मशालाएँ आसानी से मिल जाती हैं
atishay kshetra tijarah one gets more than desired here	अतिशय क्षेत्र तिजारा इच्छा से ज्यादा मिलता है यहाँ
chandra prabhu digamber jain atishay kshetra dehratijara is situated in the alvar district of rajasthan	चंद्र प्रभु दिगंबर जैन अतिशय क्षेत्र देहरातिजारा राजस्थान के अलवर जिले में स्थित है
this is called atishay area	यह अतिशय क्षेत्र कहलाता है
the meaning of atishay is more than common	अतिशय का अर्थ है सामान्य से बहुत ज्यादा
that is such an area where something extraordinary occurs or some miracle happens	यानी ऐसा क्षेत्र जहाँ कुछ असाधारण घटित हो या कोई चमत्कार हो जाए
that is if something is demanded in general one gets more than that	यानी अगर साधारण तौर पर जो कुछ माँगा जाए उससे कहीं ज्यादा मिल जाए
you get so much that you get overwhelmed	इतना मिले कि आप सराबोर हो जाएँ
such is the belief of tijara area	ऐसी ही है तिजारा क्षेत्र की मान्यता
this atishay area of tijara let s say temple is situated at a distance of kilometres from alvar district and kilometers from delhi	तिजारा का यह अतिशय क्षेत्र या कहें कि मंदिर अलवर जिले से किलोमीटर और दिल्ली से किलोमीटर की दूरी पर स्थित है
the th tirthankar of the tirthankaras shree chandra prabhu bhagawan is worshipped in tijara atishay kshetra	तिजारा अतिशय क्षेत्र में तीर्थंकरों में से वें तीर्थंकर श्री चंद्र प्रभु भगवान की आराधना की जाती है
the extremely beautiful white statue of chandra prabhu bhagawan is installed in tijara atishay kshetra	तिजारा अतिशय क्षेत्र में चंद्र प्रभु भगवान की सफेद रंग की अत्यंत मनोहारी संगमरमर की मूर्ति स्थापित है
this marble statue had come out during the excavation conducted in this area on august	यह संगमरमर मूर्ति इस क्षेत्र में कराई गई खुदाई के दौरान अगस्त को निकली थी
it is said that saraswati devi the wife of a famous doctor bihari lal of tijara area had kept fast for three days	बताते हैं कि तिजारा क्षेत्र के एक मशहूर वैद्य बिहारी लाल की पत्नी सरस्वती देवी ने तीन दिन का उपवास रखा था
on the third day of the night of fast saraswati devi saw something unprecedented about a place near her house in dream	तीसरे दिन व्रत की रात को सरस्वती देवी को सपने में अपने घर के निकट स्थित एक स्थान के बारे में कुछ अद्भुत दिखाई दिया
next morning when that place was dug the grand statue of chandra prabhu bhagawan was found	अगली सुबह जब उस स्थान की खुदाई कराई गई वहाँ चंद्र प्रभु भगवान की भव्य मूर्ति प्राप्त हुई
when the statue was taken out after the excavation devotees meant this by it	खुदाई करने के पश्चात जिस समय मूर्ति निकाली गई श्रद्धालु जनों ने इसका अर्थ यह निकाला
having full joy of the nature in train while going to goa has a different fun	ट्रेन में प्रकृति का पूरा आनंद लेते हुए गोवा जाने का अलग ही मजा है
nature itself welcomed the statue with water and purified it	प्रकृति ने ही मूर्ति का जलाभिषेक करके उसे पवित्र कर दिया
several years after this incident another black color statue of chandra prabhu bhagawan in padmasan posture was found from the same place on march	इस घटना के कई वर्ष बाद उसी क्षेत्र से मार्च को चंद्र प्रभु भगवान की काले रंग की पद्मासन मुद्रा में एक अन्य मूर्ति प्राप्त हुई
this statue of chandra prabhu bhagawan had come out during the excavations of southern gate	चंद्र प्रभु भगवान की यह मूर्ति मंदिर के दक्षिणी गेट की खुदाई के दौरान निकली थी
installed in the atishay kshetra the outer structure of this temple is extremely grand	अतिशय क्षेत्र में स्थापित इस मंदिर का बाहरी स्वरूप अत्यंत भव्य है
installed in the atishay kshetra the internal decoration of this temple is very alluring	अतिशय क्षेत्र में स्थापित इस मंदिर की आंतरिक सजावट बहुत लुभावनी है
there is so much space in the courtyard of the temple that two thousand people can easily stay present here at a time	मंदिर के प्रांगण में इतनी जगह है कि एक ही बार में यहाँ दो हजार लोग आसानी से मौजूद रह सकते हैं
the train route going to goa is full of small hills and valleys	गोवा जाने का ट्रेन रूट छोटीछोटी पहाड़ियों और घाटियों से भरा पड़ा है
there is a big hall in the tijara	तिजारा में एक बड़ा हॉल है
lead work has been done on both the sides of the tijara hall	तिजारा के हॉल के दोनों ओर दीवारों पर काँच का काम किया गया है
ancient stories have been depicted through the medium of pictures on the walls of the hall in tijara	तिजारा के हॉल की दीवारों पर चित्रों के माध्यम से पौराणिक कथा उकेरी गई है
in the temple of the atishay kshetra a person prays with true heart before this statue	अतिशय क्षेत्र के मंदिर में व्यक्ति इस मूर्ति के सामने सच्चे मन से प्रार्थना करता है
it is believed that all the desires of a person is fulfilled	मान्यता है कि व्यक्ति की सभी इच्छाएँ पूरी होती हैं
people affected with witchcraft also come to tijara to get rid of their problems	जादूटोने से प्रभावित लोग भी अपनी समस्याओं के निवारण के लिए तिजारा आते हैं
an extremely attractive pillar is installed in front of the temple	मंदिर के सामने एक अत्यंत आकर्षक स्तंभ स्थापित है
this is called by the name of manstambh	इसे मानस्तंभ कहकर पुकारा जाता है
statues of deities have been installed on the top of the pillar	स्तंभ के ऊपर भगवान की मूर्तियाँ लगाई गई हैं
the statues of the deities are visible from afar	भगवान की मूर्तियों के दूर से ही दर्शन हो जाते हैं
this is called man stambh	इसे मानस्तंभ कहा जाता है
the pride of a person lessens with mere a view of the man stambh	मानस्तंभ के दर्शन मात्र से ही व्यक्ति का घमंड कम हो जाता है
general custom is that four statues of tirthankar bhagawan is installed on the top of the man stambh	सामान्य रीति यह है कि मानस्तंभ की चोटी पर तीर्थंकर भगवान की चार मूर्तियाँ स्थापित की जाती हैं
special programs are organized twice a year in tijara	तिजारा में वर्ष में दो बार विशेष कार्यक्रमों का आयोजन किया जाता है
once on the seventh day of falgun and the second time on the tenth day of shravan shukla	एक बार फाल्गुन सप्तमी को और दूसरी बार श्रावण शुक्ल दशमी को
dharmashala with rooms has been built in atishay kshetra of tijara for the lodging of devotees	तिजारा के अतिशय क्षेत्र में श्रद्धालुओं के ठहरने के लिए कमरों की धर्मशाला बनाई गई है
tijara was famous with the name of atishay kshetra dehra in ancient times	प्राचीन काल में तिजारा अतिशय क्षेत्र देहरा नाम से प्रसिद्ध था
with the change of time this place came to be known as dehra tijara and now only tijara	कालांतर में यह स्थान देहरातिजारा और अब सिर्फ तिजारा भी कहलाता है
kanker valley national park is situated kilometres south from the district headquarters of bastar	बस्तर के जिला मुख्यालय जगदलपुर से दक्षिण में किलोमीटर की दूरी पर कांकेर घाटी राष्ट्रीय उद्यान स्थित है
kanker valley national park is famous for its waterfalls caves and biodiversity	कांकेर घाटी राष्ट्रीय उद्यान अपने जलप्रपातों गुफाओं एवं जैव विविधता के लिये प्रसिद्ध है
the main tourist places of kanker valley are as follows	कांकेर घाटी के मुख्य पर्यटन स्थल निम्नानुसार हैं
the hypnotic waterfall of tirathgarh located at distance of kilometres from jagdalpur hypnotises the minds of the tourists	जगदलपुर से किलामीटर की दूरी पर स्थित तीरथगढ़ का मनमोहक जलप्रपात पर्यटकों का मन मोह लेता है
tourists lose themselves in its charming beauty	पर्यटक इसकी मोहक छटा में खो जाते हैं
one does not feel like going away from tirathgarh	तीरथगढ़ से वापिस जाने का मन ही नहीं करता
situated on the munagabahar river this waterfall falls feet down from the moon shaped hill on the ladder like natural structures	मुनगाबहार नदी पर स्थित यह जलप्रपात चन्द्राकार रूप से बनी पहाड़ी से फिट नीचे सीढ़ीनुमा प्राकृतिक संरचनाओं पर गिरता है
the milky foam formed with the fall of water and the natural fountain of drops of water wetten the tourists gradually	पानी के गिरने से बना दूधिया झाग एवं पानी की बूँदों का प्राकृतिक फव्वारा पर्यटकों को मन्दमन्द भिगो देता है
having an m tech in geology i tried to know its geological genesis	भूविज्ञान में एमटेक होने के नाते मैने इसकी भूवैज्ञानिक उत्पत्ति जानने का प्रयास किया
i found this	मैनें यह पाया
crores of years ago the rocks of the down side river formed of moonruins due to some earthquake sloped down	करोड़ो वर्ष पहले किसी भूकंप से बने चन्द्रभ्रंस से नदी के डाउन साइड की चट्टाने नीचे धसक गई थीं
and this ladder like valley would have created this charming waterfall	एवं इससे बनी सीढ़ी नुमा घाटी ने इस मनोरम जलप्रपात का सृजन किया होगा
a temple of archaeological importance is located kilometres away from tirathgarh waterfall in chingitarai	तीरथगढ़ जलप्रपात से किलोमीटर की दूरी पर पुरातात्विक महत्व का मंदिर चिंगीतराई में स्थित है
along with tirathgarh chingitarai and chandragiri have historical importance	तीरथगढ़ के साथ चिंगीतराई एवं चन्द्रगिरी ऐतिहासिक महत्व रखते हैं
it is said	ऐसा कहा जाता है
there were two sons of a king of tirathgarh estate	तीरथगढ़ रियासत के किसी राजा के दो पुत्र थे
one was prince chandradeva and the other tirathdev	एक राजकुमार चन्द्रदेव और दूसरा तीरथदेव
prince chandradeva got the area of chandragiri in inheritance	राजकुमार चन्द्रदेव को विरासत में चन्द्रगिरी का क्षेत्र मिला
it was chandradeva after the name of whom this was named as chandragiri	चन्द्रदेव के नाम पर ही इस शहर का नाम पर चन्द्रगिरी पड़ा
whereas his brother got the estate of tirathgarh	वहीं उनके भाई को तीरथगढ़ की जागीर मिली
whose name came to be tirathgarh after his name	जिसका नाम उनके नाम पर तीरथगढ पड़ गया
ruins of archaeological importance are found in chandragiri and chingitarai	चन्द्रगिरी एवं चिंगीतराई में पुरातात्विक महत्व के अवशेष प्राप्त होते हैं
natural caves of world acclaimed kotamsar are located at a distance of kilometres from jagdalpur	जगदलपुर से किलोमीटर की दूरी पर विश्व प्रसिद्ध कोटमसर की प्राकृतिक गुफाएँ स्थित हैं
the length of this longest cave of the world is metres	विश्व की सबसे लम्बी इस गुफा की लंबाई मीटर है
formed out of the dissolution of lime stones these caves are famous for the structures made from the condensation of lime stone	चूना पत्थर के घुलने से बनी ये गुफाएँ चूनापत्थर के जमने से बनी संरचनाओं के कारण प्रसिद्ध है
due to the condensation of lime stone structures like stalactite stalagmite and dripstones are formed	चूनापत्थर के जमाव के कारण स्टलेगटाइट स्टलेगमाइट एवं ड्रपिस्टोन जैसी संरचनायें बन जाती हैं
the jingle bell hanging from the roof pillar are called stalagtite those going up from the ground stalagmite and large pillars adjoining the roof and the ground are called dripstones	छत पर लटकते झूमर स्टलेगटाइट जमीन से ऊपर जाते स्तंभ स्टलेगमाइट एवं छत एवं जमीन से मिले बड़ेबड़े स्तंभ ड्रपिस्टोन कहलाते हैं
dr shankar tiwari had described this cave for the first time	डॉ शंकर तिवारी ने प्रथम बार इस गुफा का वर्णन किया था
there are small ponds located in this cave	इस गुफा में छोटेछोटे पोखर स्थित हैं
the small fish found in the caves do not have eyes	गुफाओं में पायी जाने वाली छोटीछोटी मछलियों की आँखें नहीं पायी जातीं
the utility of their eyes finished due to staying in the dark for centuries	सदियों से अंधेरे में रहने के कारण इनकी आँखों की उपयोगिता खत्म हो गई
now these fish are blind by birth itself	अब ये मछलियाँ जन्म से ही अंधी पैदा होती हैं
this validates the principles of darwin	यह डार्विन के सिद्धांत की पुष्टि करती है
kailash caves are situated at a distance of kilometres from kotamsar	कोटमसर से किलोमीटर की दूरी पर कैलाश गुफा स्थित है
its big halls give the appearance of court of a king	इसके बड़ेबड़े हॉल किसी राजा के दरबार सा भान देते हैं
the shapes of lime stone look like shivlingas	चूना पत्थर की आकृतियाँ शिवलिंग के समान जान पड़ती हैं
therefore these caves also have religious importance	इसलिये इस गुफा का धार्मिक महत्व भी है
there is a queue of devotees on the day of mahashivaratri in the kailash cave	कैलाश गुफा में महाशिवरात्रि के दिन भक्तों का तांता लगा रहता है
kailash cave is at a height of metre and is metres long	कैलाश गुफा मीटर की ऊँचाई पर तथा मीटर लम्बी है
dandak cave is at a distance of kilometres from kotamsar	दण्डक गुफा कोटमसर से किलोमीटर की दूरी पर स्थित है
like kotamasar cave the structures like stalactite stalagmite and dripstones in dandak cave give a grand look	दण्डक गुफा में भी कोटमसर गुफा के समान ही स्टलेगटाइट स्टलेगमाइट एवं ड्रपिस्टोन जैसी संरचनायें भव्य स्वरूप प्रदान करती है
in the aranyak caves attached to the kanger valley the stalagmite structures of jadhara jhanpi and makar kaksha is spectacular	कांगेर घाटी से लगी अरण्यक गुफा में जाधरा झांपी और मकर कक्ष की अवशैल संरचनाएँ देखते ही बनती हैं
the enormous hills of the kanker appear eager to welcome the bastar district while coming from raipur to jagdalpur	रायपुर से जगदलपुर आते समय बस्तर जिले का स्वागत करने कांकेर की विशाल पहाड़ियाँ तत्पर दिखाई देती है
the charming valley of keshkal starts kilometres ahead of kanker	कांकेर से किलोमीटर आगे शुरू होती है केशकाल की मनोरम घाटी
with a hairpin curve this charming valley hypnotises tourists	हेयर पिन मोड़ लिये हुये यह मनोरम घाटी पर्यटकों का मन मोह लेती है
the hills of dandakaranya starts at the end of the keshkal valley	केशकाल घाटी के अंत में शुरू होता है दण्डकारण्य का पठार
the pleasant scene of keshkal valley is seen from the rest house and watch tower of panchavati	पंचवटी के विश्रामगृह एवं वाचिंग टावर से केशकाल घाट का मनोरम दृश्य दिखाई पड़ता है
suddenly one does not feel that we are seeing the views of plain areas	एकाएक तो यह एहसास ही नहीं होता कि हम मैदानी क्षेत्र के दृश्यों को देख रहे हैं
mountain ranges are spread far and wide	दूरदूर तक पर्वत मालाएँ फैली हैं
beautiful earth wrapped in green shawl flocks of clouds clashing with the mountains make us feel like the himalayas	हरी चादर में लिपटी सुन्दर वसुन्धरा बादलों के पर्वतों से टकराते झुण्ड हमें मानों हिमालय पर्वत सा एहसास कराते हैं
the actual border of bastar starts from here	बस्तर की वास्तविक सीमा यहीं से शुरू होती है
one has to go through geedam to reach barsur located at a distance of kilometres from jagdalpur the sadar destination of bastar	बस्तर के सदर मुकाम जगदलपुर से किलोमीटर की दूरी पर स्थित बारसूर तक पहुँचने के लिये गीदम से होकर जाना पड़ता है
barsur is situated kilometres away from geedam	बारसूर गीदम से किलोमीटर की दूरी पर स्थित है
there is huge statue of lord ganesha here	यहाँ गणेश जी की विशाल मूर्ति है
barsur has been the capital of nag kings and kakatiya administrators	बारसूर नाग राजाओं एवं काकतीय शासकों की राजधानी रहा है
barsur is famous for temples of the eleventh and the twelfth centuries	बारसूर ग्यारहवीं एवं बारहवीं शताब्दी के मंदिरो के लिए प्रसिद्ध है
among the temples of barsur the mamabhanja temple is basically a shiva temple	बारसूर के मंदिरों में मामाभांजा मंदिर मूलत शिवमंदिर है
mamabhanja temple has two sanctum sanctorum	मामाभांजा मंदिर दो गर्भगृह युक्त मंदिर है
the mandapas of mamabhanja temples are adjoined	मामाभांजा मंदिर के मंडप आपस में जुड़े हुये हैं
depiction of copulating statues are also found in the dilapidated temples of barsur	बारसूर के भग्न मंदिरों में मैथुनरत प्रतिमाओं का अंकन भी मिलता है
according to historian and renowned educationist dr jha this town was known with name of vaivashwatpur in ancient times	इतिहासकार एवं विख्यात शिक्षाविद डॉकेके झा के अनुसार यह नगर प्राचीन काल में वेवश्वतपुर के नाम से जाना जाता था
chandraditya temple was built by the naga king chandradita and it is after his name that this temple is known	चन्द्रादित्य मंदिर का निर्माण नाग राजा चन्द्रादित्य ने करवाया था एवं उन्हीं के नाम पर इस मंदिर को जाना जाता है
the battisa temple standing on thirty two pillars has been built with sand stone	बत्तीस स्तंभों पर खड़े बत्तीसा मंदिर का निर्माण बलुआ पत्थर से हुआ है
mundamahadevi built the battisa temple during the regime of someshwar dev	बत्तीसा मंदिर का निर्माण गुण्डमहादेवी ने सोमेश्वर देव के शासन काल में किया
there are beautiful statues of shiva and nandi in the battisa temple	बत्तीसा मंदिर में शिव एवं नंदी की सुन्दर प्रतिमायें हैं
this thousand year old battisa temple has been built by organizing stones in a very scientific manner	एक हजार साल पुराने इस बत्तीसा मंदिर को बड़े ही वैज्ञानिक तरीके से पत्थरों को व्यवस्थित कर बनाया गया है
these temples are protected monuments by the archaeology department	ये मंदिर आरकियोलाजी विभाग द्वारा संरक्षित स्मारक हैं
two huge statues of lord ganesha built with sand stone are surprising	गणेश भगवान की दो विशाल बलुआ पत्थर से बनी प्रतिमायें आश्चर्यचकित कर देती हैं
mamabhanja temple is excellent in view of the sculpture and worth visit	मामाभांजा मंदिर शिल्प की दृष्टि से उत्कृष्ट एवं दर्शनीय है
the vishnu temple of narayanpal was built by queen gundamahadevi of king dharavarsha of chhindak nag dynasty about kilometres away from jagdalpur in the bastar developmental block of bastar district	बस्तर जिले के विकास खण्ड बस्तर में जगदलपुर से करीब किलोमीटर दूर छिंदक नागवंशी राजा धारावर्षा की रानी गुण्डमहादेवी द्वारा नारायणपाल के विष्णु मंदिर को ईसन् में बनवाया गया
the son gundamahadevi someshvar dev was an influential king	गुण्डमहादेवी का पुत्र सोमेश्वर देव एक प्रतापी राजा था
by the completion of the vishnu temple of narayanpal dharavarsha and someshwar dev had died	नारायणपाल के विष्णु मंदिर के पूर्ण होतेहोते धारावर्षा एवं सोमेश्वर देव दिवंगत हो चुके थे
and there was the regime of chhindak nagvanshi king kanhar dev the grand son of gundamahadevi	एवं गुण्डमहादेवी के पौत्र छिंदक नागवंशी राजा कन्हर देव का शासन था
the inscriptions of gundamahadevi and her daughterinlaw the queen of king kanhar dev are here	गुण्डमहादेवी और उसकी बहू सोमेश्वर देव की रानी के शिलालेख यहाँ पर हैं
this vishnu temple of narayanpal is a protected monument by the archaeological department	नारायणपाल का यह विष्णु मंदिर पुरातत्व विभाग द्वारा संरक्षित स्मारक है
this vishnu temple of narayan pal is also the main source collecting information of the period of regime of chhindak nag dynasty	नारायण पाल का यह विष्णु मंदिर छिंदक नागवंशी शासन के समय की जानकारी प्राप्त करने का मुख्य स्त्रोत भी है
situated at the confluence of the shankhini and the dankini rivers dantewada is at a distance of kilometres from jagdalpur	शंखनी एवं डंकनी नदी के संगम स्थल पर स्थित दण्तेवाड़ा जगदलपुर से किलोमीटर की दूरी पर स्थित है
the ancient temple of the deity of bastar ma danteshwari devi is here	यहाँ बस्तर की आराध्य देवी माँ दंतेश्वरी देवी का प्राचीन मंदिर है
danteshwari devi is the symbol of the residents of bastar	दंतेश्वरी देवी बस्तर के रहवासियों की आस्था का प्रतीक है
during dashahra tourists of the world come to bastar	दशहरे के समय देशविदेश के पर्यटक बस्तर आते है
for the devotees coming on foot the facilities of free food breakfast lodging and medical treatment is made available by volunteer organizations	पैदल चलकर आने वाले श्रद्धालुओं के लिये विभिन्न स्वयं सेवी संस्थाओं के द्वारा निशुल्क भोजन नास्ते रहने एवं चिकित्सा सुविधा उपलब्ध करायी जाती है
besides the statue of danteshwari maai the statues of shiva ganesha the sun bhairava are also in bastar	बस्तर में दण्तेश्वरी माई के अलावा शिव गणेश विष्णु सूर्य भैरव की प्रतिमाएँ हैं
these statues are also important from the archaeological point of view	ये प्रतिमाएँ पुरातात्विक दृष्टि से भी अत्यंत महत्वपूर्ण हैं
watching the excavation of iron ore in bailadila is also a grand experience	बैलाडीला में लौह अयस्क का खनन देखना भी अद्भुत अनुभव होता है
mines of n are in bacheli and kirandool	बचेली एवं किरंदूल में एनएमडीसी की खदाने हैं
one can stay in the guest house in bailadila	बैलाडीला में गेस्ट हाऊस में रुका जा सकता है
getting permission is mandatory to visit the mines of iron ore in bailadila	बैलाडीला में लौह अयस्क की खदानों को देखने के लिये अनुमति लेना आवश्यक है
the mines of bacheli are kilometres away from the township	बचेली की खदानें टाउनशिप से किलोमीटर दूर हैं
the ores of bacheli are considered to be good grade	बचेली का अयस्क अच्छे ग्रेड का माना जाता है
the percentage of iron in the ores of bacheli is up to	बचेली के अयस्क में लोहे का प्रतिशत तक रहता है
k railway line kotsavalya to kirandool	केके रेलवे लाइन कोत्सावल्या से किरन्दूल
it is a romantic experience to travel by the passenger in k railway line	केकेरेलवे लाइन में पेसेंजर से सफर करना एक रोमांचक अनुभव होता है
on the way the train passing through the dense forest and skytouching hills taking uturn and mountains peeping through the clouds present a hypnotising scene	रास्ते में घने जंगल एवं गगनचुम्बी पहाड़ियों के बीच से गुजरती ट्रैन यूटर्न लेती ट्रैन एवं बादलों के बीच से झाँकते पहाड़ मनमोहक दृश्य उपस्थित करते हैं
the kind of biodiversity seen in bastar is not found anywhere else	जो जैवविविधता बस्तर में दिखलाई पड़ती है वह अन्यत्र देखने को नहीं मिलती
in the adventurous journey to bastar falls shimliguda the highest broad gauge railway station of asia	बस्तर के रोमांच भरे सफर में एशिया का सबसे ऊँचा ब्राड गेज रेलवे स्टेशन शिमलीगुड़ा पड़ता है
sellers of the juicy fruits of palm are found throughout the way	ताड़ी के रसभरे फल लेकर बेचने वाले पूरे रास्ते में मिलते हैं
it feels good to eat juicy fruits of palm	ताड़ी के रसभरे फलों को खाना अच्छा लगता है
in this adventurous journey the train running with two electronic engines pass through tunnels	इस रोमांचकारी सफर में दो इलेक्ट्रिक इंजनों से चलने वाली ट्रैन बोगदों टनल से होकर गुजरती है
the length of k line is to metres	केके लाइन की लम्बाई से मीटर तक है
the japanese had done the construction of k line to take the iron ore or bailadila to japan through vishakhapatnam	केके लाइन का निर्माण जापानियों ने बैलाडीला के लौह अयस्क को विशाखापटनम होते हुए जापान ले जाने के लिये किया था
from vishakhapatnam the iron ore was taken to japan by ships	विशखापटनम से लौह अयस्क पानी के जहाज से जापान ले जाया जाता है
food items are not found in the journey of k line	केके लाइन के सफर में खाने पीने की सामग्री नहीं मिलती
therefore if you want to enjoy this journey take enough amount of food items along	अत यदि इस सफर का आनंद लेना हो तो खानेपीने की भरपूर सामग्री साथ लेकर चलना चाहिए
k line has been transporting iron ore since the last years	केके लाइन विगत वर्षों से लोह अयस्क का परिवहन कर रही है
on an average goods train run on the k line everyday	औसतन मालगाड़ियाँ केके रेलवे लाइन पर प्रतिदिन चलती हैं
by transporting iron ore on the kilometres long k railway line the railways gets a profit of about billion every year	किलोमीटर लम्बे इस केके रेलवे लाइन से लौह अयस्क परिवहन कर रेलवे को प्रतिवर्ष लगभग बिलियन का फायदा होता है
the world famous chitrakot waterfall is located at a distance of kilometres from jagdalpur	जगदलपुर से किलोमीटर की दूरी पर विश्वप्रसिद्ध चित्रकोट जलप्रपात स्थित है
having expanded in chitrakot the indravati river forms the charming waterfall	चित्रकोट में इन्द्रावती नदी विस्तारित होकर मनमोहक जलप्रपात का निर्माण करती है
chitrakot waterfall is also called the niagara of bastar	चित्रकोट जलप्रपात को बस्तर का नियाग्रा भी कहा जाता है
watching the chitrakot waterfall in flood lights provides quite a different kind of experience	फ्लड लाइट में जलप्रपात को देखना अलग ही अनुभव प्रदान करता है
the joy of staying in the fully furnished hut of the tourism department is quite different	पर्यटन विभाग की पूर्ण सुविधा संपन्न हट में रुकने का आनंद ही अलग है
the tamraghumad waterfall is at a distance of kilometres from the chitrakot waterfall	चित्रकोट जलप्रपात से किलोमीटर की दूरी पर तामड़ाघुमड़ जलप्रपात है
in tamraghumad waterfall rivulet falling from a height of feet forms a pleasant waterfall	तामड़ाघुमड़ जलप्रपात में एक छोटी सरिता सीधे लगभग फिट की ऊँचाई से निचले भाग में गिरकर एक मनोरम जलप्रपात का निर्माण करती है
it is good to see the waterfall by climbing down	प्रपात को नीचे से उतरकर देखना अच्छा लगता है
as the road of going down is difficult it becomes necessary to take extra caution	उतरने का मार्ग दुर्गम होने के कारण अतिरिक्त सावधानी रखना आवश्यक होता है
there is a pleasant place located in the heart of jagdalpur	जगदलपुर के हृदयस्थल में स्थित एक मनोरम स्थान है
children s park and train are available here	यहाँ बच्चों के लिये बाल उद्यान एवं रेलगाड़ी की व्यवस्था है
along with this a large skating ring attracts the youths	साथ ही एक विशाल स्केटिंग रिंग युवाओं को आकर्षित करती है
beautiful lawns and flower parks hypnotise the tourists	सुन्दर लॉन एवं पुष्प उद्यान पर्यटकों का मन मोह लेते हैं
built by the great king purushottam dev of the kakatiya dynasty this pond has the pride of being the largest pond of chhattisgarh	काकतीय वंश के महाराजा पुरूषोत्तम देव द्वारा बनाये गये इस तालाब को छत्तीसगढ़ के सबसे बड़े तालाब होने का गौरव प्राप्त है
this is suitable place for morning and evening walks	प्रात एवं सांयकालीन भ्रमण के लिये यह उपयुक्त स्थान है
the facility of tour with paddle boat along with motorboat is available in the island formed in the pond	तालाब में बने आइलैण्ड में मोटरबोट के साथ पैडलबोट से सैर की सुविधा उपलब्ध है
the windmill installed in the island also attracts	आइलैण्ड में लगी पवन चक्की भी आकर्षित करती है
on the main gate of the palace of bastar there is the temple of the deity of bastar maa danteshwari	बस्तर के राजमहल के मुख्य द्वार पर बस्तर की आराध्य देवी माँ दण्तेश्वरी का मंदिर है
along with the temple the large chariot running during dashahara can also be seen at its gate	मंदिर के साथ दशहरे पर चलने वाले विशाल रथ भी इसके द्वार पर देखे जा सकते हैं
the statue of the last great king pravirchandra bhanjadeva of the kakatiya dynasty of bastar in front of the danteshwari temple is a symbol of faith the bastar residents	दण्तेश्वरी मंदिर के सामने बस्तर के काकतीय वंश के अंतिम महाराजा प्रवीरचन्द्र भंजदेव की प्रतिमा बस्तर वासियों की आस्था का प्रतीक है
the grand temple of lord balaji is on the dharampura road	धरमपुरा रोड पर भगवान बालाजी का भव्य मंदिर है
devotees from not only the state but other parts of the country also come to visit in the temple of balaji of dharampura road	धरमपुरा रोड के बालाजी के मंदिर में प्रदेश ही नहीं वरन देश के अन्य भागों से भी श्रद्धालु दर्शन करने आते हैं
the state of kerala is very popular among tourists	केरल प्रांत पर्यटकों में बेहद लोकप्रिय है
that is why kerala is called god s own country	इसीलिए केरल को अर्थात् ईश्वर का अपना घर नाम से पुकारा जाता है
there are several types of visiting places in kerala	केरल में अनेक प्रकार के दर्शनीय स्थल हैं
main among the important visiting places of kerala are	केरल के प्रमुख दर्शनीय स्थलों में प्रमुख हैं पर्वतीय तराइयाँ समुद्र तटीय क्षेत्र अरण्य क्षेत्र तीर्थाटन केन्द्र आदि
innumerous tourists from the world over come for tour to these places	इन स्थानों पर देशविदेश से असंख्य पर्यटक भ्रमणार्थ आते हैं
mountainous areas like munnar nelliyanpati ponmuti etc sea coasts like kovalam warkala cherayi etc wildlife centres like periyar iravikulam etc are the centres of attraction for kollam and alapuzha	मुन्नार नेल्लियांपति पोन्मुटि आदि पर्वतीय क्षेत्र कोवलम वर्कला चेरायि आदि समुद्र तट पेरियार इरविकुळम आदि वन्य पशु केन्द्र कोल्लम अलप्पुष़ा के लिए विशेष आकर्षण केन्द्र हैं
among indian medical systems ayurveda also has an important contribution in the area of tourism	भारतीय चिकित्सा पद्धति में आयुर्वेद का भी पर्यटन के क्षेत्र में महत्वपूर्ण योगदान है
tourism has played a defining role in the economy of the state	राज्य की आर्थिक व्यवस्था में भी पर्यटन ने निर्णयात्मक भूमिका निभाई है
daman and diu are also among the national territories of india	भारत के केन्द्रशासित प्रदेशों में दमन और दीव भी है
unfathomable waters of the arabian sea have made them main centres of trade and tourism	अरब सागर की अपारअगाध जलराशि ने इन्हें व्यापार और पर्यटन का प्रमुख केन्द्र बना दिया है
there are several small islands in daman and diu	दमन और दीव में बहुत छोटेछोटे द्वीप हैं
natural beauty mix of diverse cultures and beautiful sea coasts has gifted abundant beauty to daman and diu	प्राकृतिक सुंदरता विविध संस्कृतियों का मेल व सुंदर समुद्र तटों ने दमन और दीव को असीम खूबसूरती से नवाजा है
nearness of the states of gujarat and maharashtra has given the tourism here a full opportunity to flourish	गुजरात व महाराष्ट्र राज्य की नजदीकी ने यहाँ के पर्यटन को फलनेफूलने का पूरा मौका दिया है
for a long time daman and diu were governed by the portuguese	बहुत समय तक दमन और दीव पर पुर्तगालियों का शासन था
after that having become independent of the portuguese daman and diu were merged with goa	उसके बाद पुर्तगालियों से आजाद कराकर दमन और दीव को गोआ में मिला दिया गया
in daman and diu were given the status of a separate national territory	वर्ष में दमन और दीव को एक अलग केन्द्रशासित प्रदेश का दर्जा दिया गया
the distance of daman from mumabi the main trade center of india is about kilometres	भारत के प्रमुख व्यावसायिक केन्द्र मुंबई से दमन की दूरी लगभग किमी है
daman is attached to the state of gujarat in the east and the arabian sea in the west	दमन पूर्व में गुजरात राज्य से तथा पश्चिम में अरब सागर से जुड़ा है
in the north of daman is kolak and in the south kalai river	दमन के उत्तर में कोलाक तथा दक्षिण में कलाई नदी है
the neighbor district of daman is the valsad district of gujarat	दमन का पड़ोसी जिला गुजरात का वलसाड जिला है
diu is such an island of india which is attached with two bridges	दीव भारत का एक ऐसा द्वीप है जो दो पुलों के द्वारा जुड़ा है
diu is joined with junagarh district of gujarat	दीव गुजरात के जूनागढ़ जिले से जुड़ा है
daman is divided into two as motidaman and nanidaman	दमन दो भागों में मोटी दमन और नानी दमन में विभाजित है
the river dividing daman into two parts is damanganga river	दमन के दोनों भागों को विभक्त करने वाली नदी दमनगंगा नदी है
there are several old churches in motidaman among which the main church is the cathedral bom jesus	मोटी दमन में कई पुराने चर्च हैं जिनमें प्रमुख चर्च कैथेडरल बोल जेसू है
the paintings related to the life of jesus the messiah on the walls of the churches of daman and the fine carvings on the wood draw the tourists here	दमन के चर्च की दीवारों पर की गई ईसा मसीह के जीवन से संबंधित सुंदर चित्रकारी व लकड़ी की बेहतरीन नक्काशी पर्यटकों को यहाँ खींच लाती है
the main attraction of nanidaman is the saint jerome fort	नानी दमन का मुख्य आकर्षण संत जैरोम का किला है
the jerome fort of daman was built for defense from the attacks of the mughals	दमन का जैरोम किला मुगलों के आक्रमण से सुरक्षा के लिए बनाया गया था
besides this among other tourist attractions of daman are bom jesus church our lady of the church our lady of remidio s church pargoal garden amusement park damanganga tourist complex kachigam satya sagar udyan mirasol garden mirasol water park etc	इसके अलावा दमन के अन्य पर्यटक आकर्षणों में बोम जीजस चर्च अवर लेडी ऑफ सी चर्च अवर लेडी ऑफ रेमीडियोज चर्च परगोला गार्डन अम्यूजमेंट पार्क दमनगंगा टूरिस्ट कॉम्प्लेक्स काचीगाम सत्य सागर उद्यान मिरासोल गार्डन मिरासोल वाटर पार्क आदि हैं
the arabian sea touching the lands of daman has provided daman with unique natural beauty and greenery	दमन की जमीन को छूते अरब सागर ने दमन को अप्रतिम प्राकृतिक सुंदरता व हरियाली प्रदान की है
there are two beaches in daman devika beach and the jampore beach	दमन में दो बीच देविका बीच और जैमपोरे बीच हैं
devika beach is five kilometres north from daman	देविका बीच दमन से पाँच किमी उत्तर में है
devika beach very much lures the children because there are parks for the children and other facilities here	देविका बीच बच्चों को बहुत लुभाता है क्योंकि यहाँ बच्चों के लिए पार्क व अन्य सुविधाएँ हैं
located in nanidaman jampore beach is a famous picnic spot also	नानी दमन में स्थित जैमपोरे बीच दमन का प्रसिद्ध पिकनिक स्पॉट भी है
the peaceful environment of jampore draws lovers to jampore beach	जैमपोरे बीच का शांत वातावरण प्रेमियों को खींच लाता है
because of peaceful environment of jampore beach most of the loving couples come here in search of freedom	जैमपोरे बीच के शांत वातावरण के कारण अधिकांश प्रेमी जोड़े यहाँ स्वच्छंदता की तलाश में आते हैं
jampore beach is a very good place for swimming also	तैराकी के लिए भी जैमपोरे बीच बहुत अच्छा स्थान है
what is there in the island	क्या है दीव में
saint paul church diu fort panikota fort ghogala beach children s park and summer house are chief tourist places of diu	सेंट पॉल चर्च दीव फोर्ट पनीकोटा फोर्ट घोघला बीच चिल्ड्रन पार्क और समर हाउस दीव के मुख्य पर्यटन स्थल हैं
nagoa beach is an extremely beautiful beach of diu	नगोआ बीच दीव का बेहद ही सुंदर बीच है
you can easily reach nagoa beach after a minute drive from diu	दीव से मिनट की ड्राइव करके आप आसानी से नगोआ बीच पहुँच सकते हैं
due to being in the shape of a shoe the nagoa island spread in k has now become the first choice of tourists	जूते के आकार के समान होने के कारण किमी तक फैला नगोआ द्वीप अब पर्यटकों की पहली पसंद बन रहा है
chakratirtha beach is rich with the beauty of greenery	चक्रतीर्थ बीच हरियाली के सौंदर्य से भरपूर है
beautiful gardens near the chakratirtha beachand an open stadium make it a place of full enjoyment for the tourists	चक्रतीर्थ बीच के आसपास स्थित सुंदर बगीचे खुला स्टेडियम इसे पर्यटकों के लिए फुल इंजॉयमेंट का स्थान बनाता है
when to go to daman and diu	कब जाएँ दमन और दीव
although the climate of daman and diu attracts tourists throughout the year but suitable season to come here is from october to may	वैसे तो दमन और दीव की जलवायु वर्षभर पर्यटकों को आकर्षित करती है किंतु यहाँ आने का उपर्युक्त मौसम अक्टूबर से मई तक का है
how to reach daman and diu	कैसे पहुँचें दमन और दीव
daman has kilometres of road and the road in diu is up to kilometres long	दमन में किमी का सड़क मार्ग है तथा दीव में किमी तक लंबा सड़क मार्ग है
daman is situated on the delhimumbai route of the western railway	दमन पश्चिम रेलवे के दिल्लीमुंबई रूट पर स्थित है
the nearby railway station of daman is vapi of gujarat	दमन का नजदीक दमन रेलवे दमन स्टेशन दमन गुजरात दमन का वापी है
diu is attached with metre gauge railway line	दीव मीटर दमन गेज दमन रेलवे दमन लाइन दमन से जुड़ा है
the nearby railway station of diu is dilwada	दीव दमन का नजदीकी दमन रेलवे दमन स्टेशन दमन दिलवाड़ा है
daman and diu both are attached to airport	दमन और दीव दोनों एयरपोर्ट से जुड़े हैं
several flights take off for mumbai from diu	दीव से मुंबई के लिए रोजाना कई उड़ानें भरी जाती हैं
the main centres of temple building activities of rajasthan	राजस्थान के मंदिर निर्माण गतिविधियों निर्माण के प्रमुख केन्द्र
temple building activities in udaipur area of mewar	मेवाड़ उदयपुर क्षेत्र में मंदिरनिर्माण गतिविधियाँ
in comparison with vishnu and shiva the worship of shakti was more popular in the postgupta period mewar	
temples built at places like jagat and unwas are powerful examples of the popularity of shakt sect	
in the temples of jagat and unwas the mahishamardini form of durga has been glorified	
among the people of vaishnava sect laxminarayan and varaha forms of vishnu were specially worshipped	
built temples of gods of shiva and the sun are found very rarely in the mewar udaipur region	
the renowned places for temple building activities of the mewar province are being described	
the oldest vaishnav and sun temples in mewar were built in chittorgarh	
political and religious history and geographical location of fort have influenced the building and renovation of temples	
with the archival and archaeological evidences it is found that from second century b till seventh century a vaishnav religion was popular in this region	
besides this in mewar evidences of several ancient pilgrimage related to the religions of shaiv shakta saur buddhists and jains are found	
the statues of meditating buddha are depicted on the crevices of the wall on all the four sides of some daan stupas of th th century	
apart from this temples of th century are found as well	
during the difference of th to th century chittor was continuously the main center of activities like temple building and other sculpting renovation etcetera	
in this period the regime of maharana kumbha is specially notable for these activities	
materials used for construction were brought from nagari	
the abundance of available stones also has influenced the architecture in the mewar region	
some main temples of mewar are being described thus	
kalika mata mandir was basically a sun temple	
based on the archival evidence the kalika mata mandir can be ascertained to be of the initial period of th century	
kalika mata mandir was renovated in time	
pancharath sanctum sanctorum mandap abhyantariya pradakshina path and dwarmandap are built in kalika mandir	
statues of chariot riding sun god is honourably installed in two of the three main crevices of the sanctum sanctorum while in minor crevices the statues of chandra and other direction gods are carved	
the decoration of the arch and threshold of the entrance of the sanctum sanctorum is specially notable	
on both sides of the threshold the goddesses of the ganges and the yamuna river seated on their carriers are carved	
kurmavatar umamaheshwar and lakulish statues carved in the temple indicate the initial stage of sculpture	
kurmavatar umamaheshwar and lakulish statues carved in the temple later achieve maturity	
the top of the temple is a completely new construction	
in place of th century arch style dome like new top has been built	
two half pictures and one lakulish statue attached on the internal wall of the canopy seem to be installed later	
in fact the original place of these rock plates would have been on the platform of the temple	
the subject matter of the half picture plates is dance music and drinking	
basically the temple was built on a large platform	
some constituents of the large platform of the temple are still left	
for communication of light and air in the circumambulation path of the sanctum sanctorum two ventilators on four pillars have been built	
kumbhaswami or kumbhashyam was originally a vaishnav temple	
according to the kirti stambha edicts renovation of the kumbhaswami or kumbhashyam temple was done by king kumbhakarna maharana kumbha	
due to renovation being done by maharana kumbha it started to be known with the names like kumbhaswami and kumbhashyam etc	
this temple is contemporary of the kalika mata temple and its architecture planning and style also matches with it	
on the one side where the architecture plan of the temple prominent and blank back undecorated thighs and circumambulation path the god statues of the outer crevices of the sanctum sanctorum seem to be a construction of th century	
due to being built in different periods this temple of kumbhaswamy has cherished several examples of architecture styles and statue crafts	
according to shri dhaki it was king manbhanga who built this temple also	
king manbhanga has the credit of building the temples like kalika mata sun temple the nearby tadaga and tripurvijaya prasada etc	
according to shri dhaki the kumbhaswamin alam of the kirtistambha edict was the ancient tripur vijaya	
kumbha had rebuilt the ancient tripur vijaya kumbhaswamin alam	
the seminary canopy of the present kumbhashyam temple has been rebuilt with the ancient ruins and new stones	
new vaishnava statues have been installed instead of old dilapidated shaiva statues	
protected shaiva temples have been kept as it is	
ashwadhar naradhara built on the back of the temple and total lack of the grass bar certainly defines it to be of the th century	
kumbhashyam is a sandhan type of east facing structure	
the sanctum sanctorum of the temple is of the trayanga type	
every part of the sanctum sanctorum is attached with a salilantar	
the statues of digpalas standing in a triangular way on each corner look extremely beautiful	
there are three branches of the chariotlets of bhadra patravalli nagapasha and roopa branch	
the samadhishwar temple in chittor fort had a place among the important temples	
shiva samadhish had an important place in the life of the people of chittor	
according to some records samadhishwar temple is known as samidheshwar and in colloquial form as samidhesur as well	
there is disagreement among the historians on the builder installed god construction time and name of the samadhishwar temple	
according to an edict of a maharaja mokal had renovated the samadhishwar temple	
samadhishwar temple is also known as mokal temple	
according to some scholars like shri dhaki samadhishwar temple is the kumar vihara built by chalukya kumarapala	
based on the narathar and kumbhak of vedi bandh and the statues of goddesses and yaksha yakshinis of the jain regime on jangha and based on the edict of a of kumarapala found from the complex of the samadhiswar temple itself it has been considered to be a jain temple	
in the edict of kumarapala is found the evidence of his being a shiva worshipper only	
according to the mohaparajay play of yashpal kumarapal had accepted jain religion in a samvat however late	
the depiction of scenes available in the samadhishwar temple is generally found from all the jain and hindu temples	
the palatial materials and takshak of jain and hindu religions used to be the same	
thus the samadhishwar temple appears to be a shaivite mansion from top to end instead of kumarpala vihara	
the mahesha statue of the shiva of samadhishwar temple that is vamadev is a form of direct bhairav	
the largeness and wonderfulness of the mahesha statue is unique	
the mahesha statue that is vamadev seems to be of later than th century from the point of view of style	
the ground of sanctum sanctorum is lower than the internal canopy	
it appears that this change has been done during renovation	
dr ramnath and several other scholars have tried to identify this mansion and its construction period with the tribhuvan narayan temple built by the parmar ruler bhoja	
according to them this temple was built in a by king bhoja	
its description is in the record found in chirawa	
kalyanpur is located at a distance of kilometres south of udaipur and has been popular as a shaivapeetha	
at present the temple is in extreme dilapidation	
according to found records it has been determined to be of th century	
the statues of the temple are made of parewa stone having some greenishness	
the statues of the temple are at present conserved in the pratap museum and m college udaipur	
ahar mewar region is an important place from the point of view of sculpture	
the ancient names of ahar mewar region is aghatpur atpur and gangodbhed tirtha	
this was a major center of vaishnav sect in the th th century	
mention of a vishnu temple is found in a record of a samvat found in ahar	
a statue of adi varaha was installed in ahar by a vaishnav devotee	
there was a sun temple in ahar	
the proof of the sun temple is found in a record mentioning the contribution of drammas	
in another temple the laxminarayana form of vishnu was worshipped which is now known with the name of mirabai temple	
besides the statues of brahma savitri laxmi narayan sitting on barud uma maheshwar seated on nandi etc in the outer crevices of the temple the scenes of contemporary social life have also been presented	
unwas is famous for the durga temple	
unwas is situated near haldi ghati kilometres away from udaipur	
the durga temple of unwas is renowned with the name of pippaladmata in the common mass	
the durga temple of unwas built in th century is contemporary of the ambika temple of jagat and this is supposed to be built in the regime of a guhil ruler allat	
the durga temple of unwas is counted in the group of the temples of jhalarapatan and jagat built under the matripuja tradition	
in the group of the temples of jhalarapatan and jagat a form of shakti was worshipped uniquely	
in this the mahishmardini form as peaceful and the grandness of varada form has been presented	
compared to sculpture the above mentioned temple of unwas is more important for the study of the development of meaning in architecture	
there is a lack of decorative meanings of the back of the temple	
situated kilometres away from udaipur jagat is known for historical ambika temple	
there are three main parts of this group of temple seminary canopy main temple and a small temple built on the waterway of the main temple	
the use of seminary canopy would have been for musical performances in occasions of the goddess	
both the pillars of the entrance are also almost extinct	
a statue of alaskanya standing on the upper part of these pillars was depicted	
the carved meanings of the peethika is still safe	
situated kilometres away from udaipur nagda has been the ancient capital of guhil rulers	
the record of a samvat certifies the anciency of the nagada place	
at the same time based on the style of archaeological materials nagda does not appear to be so ancient	
possibly ancient monuments would have dilapidated with time	
saas temple is big in size	
as the guhil rulers were suryavanshi this temple of nagda has been dedicated to vishnu	
a four armed vishnu statue is honourably installed in the main crevice of the back of the sanctum sanctorum	
on the external parts of both the temples depiction of making up men and women have been done	
a shakti temple is built on the right side corner of the saas temple in which different forms of shakti have been depicted	
another group of temples near nagda itself is known with the name of eklinga or kailashpuri	
the inscription found from the lakulish temple of nagda is of a and this is the most ancient	
other temples are of th century	
tus is located on the banks of the berach river near udaipur and the sun temple here has an important place in the study of sculpting tradition	
in comparison with the vaishnav sect the sun worship was less popular in the mewar region	
a beautiful landmass located between the western side of the arabian sea and the sahyadri mountain ranges is known by the name of kerala	
the area of the state of kerala is square kilometres	
malayalam language is spoken in kerala	
recognized due to its culture and language specialties kerala has an important place among the four states situated in the south of india	
major neighboring states of kerala are tamil nadu and karnataka	
the landmass known by the name of mayyazhi mahe of the state of pondicherry puducchery is also under the kerala state	
the national territory of lakshadweep situated in the arabian sea also has an unbreakable relation with kerala in view of the language and culture	
before the achievement of independence there were estates of kings in kerala	
in july the state of tirukochi was constituted by joining the estates of tiruvitankur and cochin	
at that time the region of malbar was only a district of the madras state present tamilnadu	
in november malbar was also joined with tirukochi and thus the present kerala was established	
thus by constituting aikya keralam the long time desire of the people of this part of land was fulfilled	
kerala can be proud of its ancient history long time foreign trade relation and the rich tradition of science and arts	
in view of literacy kerala has an important place in the whole country	
kerala has an important place in the areas of social justice health level men women equality and obedience of law education etcetera	
the most important thing is that infant mortality rate is the lowest in kerala	
due to more rains the water mass of the kerala region is rich and the land here is always covered with greenery	
due to excellent weather the good facility of transport and the rich cultural tradition the state of kerala is famous among tourists	
not only this other specialties of kerala are wakened political awareness the impact of media the capacity to absorb other cultures etc	
famous for mutual religious respect kerala is the confluence land of different cultures	
there is no unanimous opinion among scholars on the issue of the derivation of the word kerala	
it is said that the word kerala has been formed with the combination of the words chersthal keechad and alampradesh	
there is another meaning of kerala the land that came out of the sea	
the confluence place of the sea and the mountain is also called kerala	
ancient foreign wanderers have addressed this place with the name of malbaar as well	
the culture of kerala is thousands of years old	
in the beginning people used to live in hilly areas	
some ruins of the ancient stone age have been found from some parts of kerala	
besides the ancient ruins the megalithic commemorative volumes also give authentic information about the human life in kerala	
these megalithic memorabilias are found mostly in the form of crematorium	
many crematoriums of the ancient stone age have been found here	
these are known with the names as kudakkallu umbrellashaped cliffs toppikkallu capshaped stones kalmesha table made of stone muniyara shed of saints nannangadi pit of ashes etc	
their period is supposed to be from b to	
most of commemorative volumes of the megalithic age have been found from the hilly areas	
so it is proved that the residence of the humans was in kerala from the most ancient times	
the second stage of the development of the living centers in kerala is supposed to be the sangam age	
this is the very age of the formation of ancient tamil literature	
sangam age continued from a to a	
it is in this period that people coming from other provinces started settling down in kerala and the propagation of buddhism and jainism occurred	
the brahmin arrival also happened in this very period	
there were overall settlements of the brahmins in different areas of kerala in those days	
the christian religion had reached kerala by the first century of jesus	
in ad christian faithful of the seven tribes of western asia under the leadership of thomas of kanaye came and settled in kerala	
christian religion propaganda got strength in kerala with the seven tribes of the western asia	
the citizen of kerala got acquainted with the islam religion since eighth century itself	
the historians considered the ancient kerala as a part of the tamil region	
the main elements which helped in the independent development of kerala are the citizen s love for nature the development of residential centers rise of industrial center and language enrichment	
a lot of social changes occurred in kerala when the control of agriculture and resources came in the hands of landlords	
as a result development from small estates to large states took place	
thus the history of kerala is the history of empires and wars	
it is a history of language and literature	
it is the history of the arrival of foreign armies and becoming their long term colony it is the history of the casteism and exploitation	
it is the history of the progress occurring in education and promotion taking place in the scientific areas	
it is the history of commercial progress and social renaissance and the emergence of democratic institutions	
for the sake of convenience the history of kerala can be divided into three parts ancient middle age and modern age	
kerala is rich with rare vegetation and animals and bushes	
though there are large trees also here but chinnar is appropriate for all the bushes here	
rare brown colored squirrels which are on the verge of extinction is found here	
the number of these squirrels giant grizzled squirrel of india in the world is about	
here rain ensues very less in comparison with other wild areas of kerala	
rain ensues here only days on an average in a year	
a place named chandanakkadu near chinnar is appropriate for wildlife view	
wild oxen can be seen in this dense forest	
elephant leopard hanumanmonkey peacock etc are seen on both sides of the road	
the nearest railway station ernakulam k	
the nearest airport kochhi international airport k	
this place is filled with fields of large grass and shady trees	
spread in about square kilometres this national park is very charming	
this is the natural living place of the nilgiri cow	
the nilgiri cow is becoming extinct now	
here animals like nilgiri long tailed monkey short tailed monkey leopard tiger etc are also found	
this region is specially conserved so tourists can only enter the tourist area	
there is no permission to go there during the time of monsoon	
gavi is internationally acclaimed ecotourism center	
gavi is under the kerala forest development centre	
the world tourism organization called alistair international has emphasized on the necessity of tourism by the tourists in this area	
gavi is an appropriate place for wild animal observation tracking etc	
local people work cheap for all the works starting from erecting the tent in the forest to providing ready food in gavi	
the travel of gavi starts from the middle of the tea gardens	
crossing the places like mundakkayam kuttikkanam peerumedu etc we go to gavi through vandiperiyar	
one can stay in the ecolodge named green manson after reaching gavi	
if you want to stay in tents after establishing it near a tree or houses made on trees it is also possible	
gavi lake is near ecolodge	
there is boating facility here	
forest field of grass hills valleys garden of cardamom plants etc are seen around the lake	
animals like the nilgiri cow short tailed monkeys etc can be seen at a very close distance	
overall species of birds live here including malmusshkki the bird whose sound echoes in the hills the pied cuckoo woodpecker the blue jay etc	
coming out of gavi we can go ahead	
animals coming out in the night can also be seen by traveling kollur gavi grass gardens kochhu pampa pachhakkanam etc	
living in gavi tree house and tents etc one also gets the opportunity to savor the wildlife	
gavi is k from vandiperiyar and k from tekkadi	
echo point is very appropriate place for adventure tourism and tracking	
echo point falls on the way from munnar to top station	
the area of echo point is surrounded with hills like mankunnu kodiyatturmala tonippara etc and is appropriate for tracking	
ilvishapunchira is near kanjar	
going to kanjara from palaya of kottayam district is easy	
a fascinating waterfall forms with the water falling from a height of metres along with a fierce roar in kanjar	
kanjar waterfall remains filled with water whole year	
kanjar is appropriate for tracking	
enough amount of herbs are found in kanjar	
attukal presents a fascinating scene with waterfall curvy hills	
if you want to visit the whole of goa in the shortest time and with the least money then take the services of the tourist buses	
kanjar is in between munnar and pallivasal	
the natural place for sandal trees in kerala is marayur	
the visiting places of marayur are the sandal factory of the forest department the caves decorated with the stone age images the shady banyan tree expanding over one hectare etc	
tuvanam waterfall rajeev gandhi national park etc are situated near marayur	
the archaeological supremacy of marayur is also no less than others	
stone age caves and several ancient graves have been excavated here	
indoswiss dairy farm is one of the visiting places in mattuppetti	
the indoswiss dairy farm of mattuppetti has been built metres above the sea level	
there are modern cowsheds in indoswiss dairy farm	
from these modern cowsheds only three cowsheds have been opened for tourists	
other sights here are mattupetti dam lake the kundala tea garden kundala lake etcetera	
d has managed the boat travel in this lake	
the center of pallivasal water electricity plan of is situated near mattupetti	
munnar is one of the popular hill stations of india	
the natural splendor of munnar drenching the heart and soul with pleasure is indescribable	
due to being located at confluence of the rivers of mudrappuzha nallatanni kundala etc unique greenery is seen in munnar	
munnar is a hilly area situated at a height of metres above the sea level	
munnar was one of the important summer residences of india	
the british used to reside in munnar during the british regime	
it was the owners of the british gardens who got the tea garden planted in munnar	
it is the specialty of munnar is that here tourists never get bored	
it is good to travel through the middle of the tea garden at a distance of k from munnar town	
there is a dense forest around the dam	
top station is the highest area k away from munnar on munnar kodaikanal road	
it is here that the world famous flower called neelkurinji blooms	
one can also get to see the glimpse of tamilnadu from the top of these hills	
neelkurinji blooms once in twelve years	
this is boon of nature for kerala	
when neelkurinji blooms it seems as if the hills are drowned in blue color	
these flowers are found in about shades of blue color	
when it blooms it appears as if whole nature has bathed in blue color	
this mesmerising view of nature enchants the tourists in the areas of koviloor kadavari rajmala iravikullam munnar	
last time neelkurinji bloomed in	
although neelkurinji blooms every year on some hills but for total blue flower festival we will have to wait till	
tea museum should also be given place in munnar tourism program	
tea museum is in the tea estate known as nalltanni which is under the ownership of tata tea	
important among the ancient items displayed in the tea museum of munnar are the chain of development of tea farming in munnar ancient instruments which were used for transforming the dense forests into tea garden	
tea roller of peltan wheel of parts of the trains running on the light rail track founded in high range for carrying the tea etcetera	
the exhibition of different levels of the production of tea leaf is very attractive	
another important thing is a funeralashespot of second century before christ which you can see	
besides this the traditional systems of tea production tea leaves of different types have also been displayed here	
pandikkushi area of idukki district is appropriate for the photography of forests and wild life	
the abundant nature of pandikkushi and diverse wild life enchant visitors	
pandikkushi is situated on the border of tamilnadu near chellarkovil	
peerumedu is a hill station situated an a height of metres above the sea level	
gardens of tea coffee rubber cardamom eucalyptus etcetera keep the greenery of peerumedu alive	
the field of grass waterfall pine tree etcetera increase the beauty of peerumedu fourfold	
peerumedu is a suitable place for tracking cycling horse riding etcetera	
pulmedu is an evergreen mountain range near the periyar river	
shabarimala temple is visible from peerumedu	
pulmedu falls on the way to shabarimala temple	
we can reach pulmedu by jeep only	
as it is a preserved forest area it is necessary to take permission from the forest department for visit	
chellarkovil is a part of peerumedu itself there are several waterfalls here	
chellarkovil area is rich with extremely charming nature	
standing rock is a part of chellarkovil village	
coming down the standing rock of chellarkovil village is standing up to the coconut gardens situated in kambam of tamilnadu	
vandiperiyar is a nature enriched region	
tea coffee black pepper etcetera are cultivated in vandiperiyar	
periyar river flows through the midst of it	
there is a government agriculture park and a flower garden here	
this hill is the center of fruits flowers vegetables etcetera	
the meaning of the name pattumala is the mountain filled with greenery which appears as if covered with green silk	
the beauty of pattumala situated in peerumedu is transcendental	
pattumala in its beauty is charming the world	
situated on top of the green mountain of pattumala velankanni mata church is a famous pilgrimage	
there is a beautiful park also just near the church	
vandanmedu is world famous cardamom sale center	
there is a crowd of traders of the world over in the auction center of vandanmedu	
idukki is a forest region with dense jungles and fields of grass	
tattekkad comes under the devikulam tehsil of idukki district	
about rare species of birds are found in taddekkad idukki	
therefore the government of kerala has established a bird sanctuary in this area after the name of acclaimed ornithologist dr saleem ali	
the bird sanctuary of tettekkad idukki is world famous	
tattekkad idukki is k away from kochi city	
situated between the two streams of the periyar river tattakkad is an island with an area of square k	
besides several species of birds animals of types large trees nine types of reptiles etcetera are found in tattekadu	
idukki wildlife sanctuary is situated at a height of metres above the sea level	
idukki wildlife sanctuary is spread in an area of square k ms	
idukki wildlife sanctuary comes under the thodupuzha and udumpanchola tehsils	
idukki wildlife sanctuary is a forest area in the middle of periyar and cherutonipuzha	
periyar and chrutonipuzha forest area are evergreen woods in this area	
animals like wild boar tiger etcetera live in periyar and cherutonipuzha	
cobra viper shining serpent mainah nightingale woodpecker sparrow etc are also found in this forest	
idukki wildlife sanctuary is near the idukki dam	
there is also a facility of boat travel from periyar	
vandiperiyar is nature enriched region	
farming of tea coffee black chilly etc are done in vandiperiyar	
periyar river flows from the middle of vandiperiyar	
government agriculture parks and flower gardens are there in vandiperiyar	
vandiperiyar hill is the center of fruitsflowers vegetables etc	
ramakkalmedu is tourist center with calm beautiful atmosphere and slow wind	
views of kambam bodi etcetera are seen at a distance from the hill	
ramakkalmedu is situated k from idukki and k away from munnar	
the buses go for ramakkalmedu in the morning at oclock from munnar oclock from kottayam and oclock from ernakulam	
the famous ayurveda center named sahyadri is in pallikkunnu	
sahyadri ayurveda centre is under the peerumedu development committee	
there is a park of herbal vegetation near sahyadri ayurveda center where in essential medical herbs have been grown for medicine	
besides the treatment of different diseases in sahyadri herbal center welfare treatment i health improvement treatment has also been arranged	
kerala can be proud of periyar wildlife sanctuary	
periyar wildlife sanctuary is situated on the shore of periyar lake	
this region of periyar wildlife sanctuary situated on the western coast is rich with unique greenery	
animals like elephant deer tiger short tailed monkey etc are found here	
hordes of elephant grazing in the dense grass fields of the shore are seen while boating on the river	
we can reach the shila temple mangla devi temple situated at the center of the forest by trekking in thekkady forest	
thekkady is the most appropriate place to capture the pictures of wild elephants	
two institutions in thekkady provide the lodging facility tiruvitankur kings summer bungalow of the lake palace and aranyanivas	
the lake palace is in a small island on the shore of aranyanivas lake	
now both are under the ownership of k	
the mountainous place of trishanku mala is very charming	
an enchanting charm is spread in trishanku mala	
viewing sunset from the top of hills in trishanku mala equals viewing the beauty directly	
but it needs courage to look down from the trishanku mala	
while enjoying the silky touch of the slow wind in trishanku mala it would be an indescribable experience to pass touring the forest areas	
trishanku mala is located at a distance of k from peerumedu and half k from kuttikkanam	
it is said that this hill became famous with the name of peerumala after the name of a sufi saint named peer muhammad	
this is a favorite place of the nomadics and trekking lovers	
kilimanoor palace is k away from thiruvananthapuram railway station	
from the thiruvananthapuram airport kilimanoor palace is k away	
peerumala sufi mausoleum deewan bhawan the summer palatial mansion of the member of royal family are the things worth seeing	
peerumala is k away from peerumedu and one k away from kuttikkanam	
peerumala is k away from kottayam railway station	
kochi international airport the nearest airport of peerumala is k away	
innumerous stories about vagaman are popular	
the matchless beauty of vagaman gives relish to both the eyes and the ears	
it appears that the glimpses of secret beauty has inadvertently appeared on the hills covering itself in greens	
the beauty of this region unveils gradually before the visitors of this greenery standing in vagaman	
there are such hills around vagaman where the tomb of muslim thangal the temple of hindu murugan christian church identified as cruce hill exist	
there is pine forest at the slopes in vagaman	
the dairy farm under the church is also worth visiting	
vagaman is k away from peerumedu one can go to vagaman by bus	
kottayam the nearest railway station of vagaman is an a distance of k	
kochhi international airport the nearest airport of vagaman is at a distance of k	
vattavada is a village located k east of munnar	
vattavada is popular for its natural beauty and calm atmosphere	
different places of tourist attractions in vattavada have not yet come forward completely	
vattavada is worth visiting due to its vegetation parks in the same fashion as is munnar beautiful due to the tea gardens	
vattavada is also situated feet above the sea level still there is no unbearable cold in vattavada during winter days	
vegetables are farmed in vattavada after leveling the ascents of mountain	
different kinds of butterflies and birds are found in vattavada	
the journey to kodaikanal top station mattuppetti kantallur meesapulimala can only be done from vattavada	
for this the journey can also be done by jeep or motorcycle	
services of private agencies are also available for erecting tent in vattavada and the jungle	
vattavada is k far from munnar by road	
the nearest railway station ernakulam junction is k away from vattavada	
kochi international airport is k away from vattavada	
aralam is a wildlife sanctuary	
aralam is spread in an expanse of square k on the slopes of sahyadri	
deer elephants bisons wild boars etcetera roam commonly in aralam	
leopard wild cat and different types of squirrels etcetera can be seen sometimes	
spread in hectares aralam farm is located near it	
aralam is situated k away from thalassery and k away from kannur	
thalassery is the nearest railway station from aralam	
the nearest airport from aralam karipur international airport is k away from thalassery	
the lake known as kavvayi in this part of north kerala spreads matchless grandeur	
canals like kavvayi and kankol vannathichal kuppithodu kuniyan etcetera form into lake	
kavvayi lake is square k long	
for complete enjoyment of the beauty of the lake travel should be done by boat in the kottikottapuram way	
nearest to the kavvayi lake the payyannur railway station is k away	
karipur international airport kannur is the nearest airport of kavvayi lake at a distance of k	
sheltered in pazhayangadi of kannur madayipara is rich with biodiversity and historical tradition	
ezhimala was the capital of kolattunad kings	
coronation of kolattunad kings used to complete in madayipara from th century till th century	
the ruins of the old castle is in the southern valleys of the hill	
a pond is here which has the shape of long handled mirror	
it is said that the construction of the pond was got done by the jews	
other attractions of madayipara are the shaivite temple the pond of the temple spread over an acre and madayi kavu the sacred place in the dense forests	
the organization of madayipuram festival is related to madayi kavu	
other attractions of this hill are fruits and flowers of different species tubers of species hundreds of the herb species meat eater vegetations birds of different species etcetera	
the biggest butterflies of the world atlas butterflies use to come to madayipara for getting hospitality	
considering the historical and zoological specialties of madayipara area the state government has prepared special plans for their conservation	
the nearest railway station of madayipara pazhayangadi is at a distance of k	
the nearest airport from madayipara karipur international airport is at a distance of k	
malayala kalagramam is a training center for artists	
the opportunity to learn several arts and to practice them is provided in malayala kalagramam	
full time training is provided in picture drawing sculpture song dance ceramics etc at malayala kalagramam	
the classes of yoga and sanskrit etc are also run in malayala kalagramam	
seminars on the subjects of the culture and history of kerala are organized in malayala kalagramam	
the library of kalagramam is excellent	
spending a day with the teacher and the students of malayala kalagramam gives a new experience	
malayala kalagramam new mahi is situated at a distance of k from kannur	
mahi is the nearest railway station of malayala kalagramam	
the nearest airport karipur international airport is at a distance of k from malayala kalagramam	
kanimangalam is famous for sculptures and the lamps made of brass	
kanimangalam is near payyannur	
muzhappilangad beach is one of the unique drivein coasts of kerala	
the feeling of journey by a vehicle on the coast of about k long muzhappilangad beach is extraordinary	
several gigantic rocks are standing stopping the encroachment of high waves of the sea at muzhappilangad beach	
many natural pools have formed due to these rocks	
that is why muzhappilangad beach is considered as the heaven of the swimmers	
the coconut trees standing parallel to the coast cast shadow on the coast	
muzhappilangad beach is k far from kannur and k away from thalassery	
kannur the nearest railway station of muzhappilangad beach is k away	
mangalore the nearest airport of muzhappilangad beach is k away while karipur international airport is k away	
payyambalam seacoast is appropriate for spending evening with calm	
till some time ago payyambalam seabank was the center of picnic for the local public	
gradually the arrival of tourists on payyambalam seabank is increasing	
kannur the nearest railway station from payyambalam seacoast is at a distance of k	
the nearest airport from payyambalam the karipur international airport is at a distance of k	
built by portuguese viceroy francisco de almeida in	
the fort made of red stones is in triangular shape	
the dutch had captured the saint angelo fort in and sold to ali king of kannur	
in the british took saint angelo fort under their own dominion and made it the main center of the malabar soldiers	
today the st angelo fort is a conserved monument under the department of archaeology	
a sea wall has been built outside the st angelo fort	
the sea wall saves st angelo fort from the beatings of the waves	
mappila bay fish collection harbor dharmadam island etcetera can be seen while standing at the st angelo fort	
mappila bay harbour is a boon of nature	
mappila bay harbour has been modernized under the indonorwegian project	
dharmdam island whose expanse is acre is only metre away from seashore	
kannur the nearest railway station from st angelo fort is at a distance of k	
the nearest airport from saint angelo karipur international airport is k away	
thalassery has gained special place in the history of kerala	
continuous connection with overseas commercial tradition mature cricket tradition the tradition of circus etcetera are included among the prosperous heritages of thalassery	
the portuguese and the dutch had tried to capture thalassery	
the british army chief arthur miller who had come to capture the pazhassi king stayed in thalassery for a long time	
