dwarka is also a dhaam among the chaar dhaams	द्वारका चार धामों में एक धाम भी है
lord krishna had specially settled this amidst the sea	भगवान कृष्ण ने इसे समुद्र के बीच में विशेष रूप से बसाया था
situated on the western railway s surendranagarokha port line this city is a coastal station	पश्चिम रेलवे की सुरेंद्रनगरओखा पोर्ट लाइन पर स्थित यह नगर समुद्र किनारे का स्टेशन है
this holy city is mathura the avatar land of lord shrikrishna on the banks of the yamuna	यमुना तट पर भगवान श्रीकृष्ण की अवतार भूमि का यह पवित्र नगर मथुरा है
mathura station is on the northeastern railway s line going to gorakhpur from agra fort and on the western railway s mumbaikotadelhi line	पूर्वोत्तर रेलवे की आगरा फोर्ट से गोरखपुर जाने वाली लाइन तथा पश्चिम रेलवे की मुंबईकोटादिल्ली लाइन पर मथुरा स्टेशन है
garhmukteshwar is a sacred pilgrimage of the hindus	गढ़मुक्तेश्वर हिंदुओं का पावन तीर्थ है
let us go to the ganges fair of garh mukteshwar	चलें गढ़ मुक्तेश्वर का गंगा मेला
the history of north india s famous and ancient religious fair held every year on the occasion of kartik poornima on the banks of the fallen purgator ganges in the garh mukteshwar of ghaziabad district	गाजियाबाद जिले के गढ़ मुक्तेश्वर में पतित पावनी गंगा के तट पर हर साल कार्तिक पूर्णिमा के अवसर पर लगने वाले उत्तर भारत के प्रसिद्ध और प्राचीन धार्मिक मेले का इतिहास लगभग पाँच हजार वर्ष पुराना है
there is full fervor of the fair this time also in garh mukteshwar and huge crowd of devotees is gathering for the holy dip	इस बार भी गढ़ मुक्तेश्वर में मेले की भरपूर गहमागहमी है और मुख्य स्नान के लिए श्रद्धालुओं की भारी भीड़ जुट रही है
the holy dip is on november	मुख्य स्नान नवंबर को है
it is said about garh mukteshwar that on looking at the detriments of the war and genocide after the disastrous war of the mahabharata yogiraj krishna dharmaraja yudhisthir and arjun regretted hugely	गढ़ मुक्तेश्वर के विषय में कहा जाता है कि महाभारत के विनाशकारी युद्ध के बाद योगीराज श्रीकृष्ण धर्मराज युधिष्ठिर व अर्जुन के मन में युद्ध की विभीषिका और नरसंहार को देखकर भारी ग्लानि हुई
they began thinking as to what should be done for the peace of the innumerable relatives colleagues and innocent people killed in the war	वे इस सोच में पड़ गए कि युद्ध में मारे गए असंख्य कुटुम्बियों बंधुओं व निर्दोष लोगों की आत्मा की शांति के लिए क्या उपाय या संस्कार किया जाए
then all decided unanimously	तब सबने एक राय से निर्णय लिया था
all the sanskars will get completed with worship of the mukteshwar mahadev at a place called shiv ballabhapur established by lord parashuram in khandavi forest yajna and a bath at the fallen purgator ganges and offering a pindadan there	खांडवी वन में भगवान परशुराम द्वारा स्थापित शिव बल्लभपुर नामक स्थान पर मुक्तेश्वर महादेव की पूजा यज्ञ तथा पतित पावनी गंगा में स्नान करने और वहाँ पिंडदान करने से सभी संस्कार पूर्ण हो जाएँगे
it is to be noted that it is shiv ballabhpur that is known as garh mukteshwar now	ज्ञात रहे कि शिव बल्लभपुर को ही अब गढ़ मुक्तेश्वर के नाम से जाना जाता है
maharaj shivi the ancestor of lord rama had spent his exile at garh muktesher	भगवान राम के पूर्वज महाराज शिवि ने अपना वानप्रस्थ गढ़ मुक्तेश्वर में ही व्यतीत किया था
maharaj shivi had lord parashuram establish the shiva temple here	महाराज शिव ने भगवान परशुराम से यहाँ शिव मंदिर की स्थापना कराई थी
at that time garh mukteshwar was the main center of ballabh sect	उस समय गढ़ मुक्तेश्वर बल्लभ संप्रदाय का मुख्य केन्द्र था
garh mukteshwar was named as shiv ballabhpur	गढ़ मुक्तेश्वर का नाम शिव बल्लभपुर पड़ा
the description of garh mukteshwar is found in the shiva purana	गढ़ मुक्तेश्वर का वर्णन शिव पुराण में मिलता है
a yajna was conducted from the eleventh day to the fourteenth day of the fortnight in garh mukteshwar for the peace of the souls killed in the war of the mahabharata	एकादशी से चतुर्दशी तक गढ़ मुक्तेश्वर में महाभारत युद्ध में मारे गए सभी लोगों की आत्मा की शांति के लिए यज्ञ किया गया
on the evening of the fourteenth day after the end of the yajna tributes were offered to those souls by offering earthen lamps in the ganges	चतुर्दशी की संध्या को यज्ञ की समाप्ति पर उन आत्माओं को गंगा में दीप दान कर श्रद्धांजलि अर्पित की गई
next day on the full moon morning having bathed in the ganges all offered prayers and religious stories	अगले दिन प्रात पूर्णमासी को सभी ने गंगा स्नान कर पूजाअर्चना कथा आदि की
every year devotees in lacs of numbers come to garh mukteshwar to take a bath in the blemishdestroyer sinpurgator ganges and to offer earthen lamps for the peace of the souls of their kins	प्रत्येक वर्ष लाखों की संख्या में श्रद्धालु गढ़ मुक्तेश्वर कार्तिक पूर्णिमा पर कलुष विनाशनी पापहरिणी गंगा में स्नान करने और अपने स्वजनों की आत्मा की शांति के लिए यहाँ दीप दान करने आते हैं
innumerous people offer earthen lamps in the ganges as tribute to their kins on the evening of the fourteenth day of the fortnight	चतुर्दशी की शाम को असंख्य लोग अपने स्वजनों को श्रद्धांजलि देने के लिए गंगा में दीप दान करते हैं
during that time lamps flowing with the stream of the ganges appear very peace giving and charming	उस वक्त गंगा की धारा के साथ बहते दीपों का दृश्य बड़ा ही शांतिदायक और मनोहारी प्रतीत होता है
there are several places of religious importance in garh mukteshwar such as nahush well the temple of the mukteshwar mahadev the badrinath templeh	गढ़ मुक्तेश्वर में धार्मिक महत्व की कई जगहें हैं जैसे नहुषकूप नक्का कुआँ मुक्तेश्वर महादेव का मंदिर बद्रीनाथ मंदिर आदि
custom is that the badrinath temple is opened during the prayer time only	प्रथा है कि बद्रीनाथ मंदिर को केवल आरती के समय ही खोला जाता है
this temple is opened only once in a year for the whole day during the birth anniversary of parashuram on akshaya tritiya	यह मंदिर साल में केवल एक बार अक्षय तृतीया को परशुराम जयंती पर दिन भर दर्शनार्थियों के लिए खोला जाता है
there is a sand filled field in front of the mukteshwar mahadev temple which is known as meerabai ki reti	मुक्तेश्वर महादेव मंदिर के सामने विशाल रेतीला मैदान है उसे मीराबाई की रेती के नाम से जाना जाता है
it is believed that meerabai had come to bathe here once	ऐसी मान्यता है कि एक बार मीराबाई यहाँ गंगा स्नान के लिए आई थीं
it is said that once parvatiji asked a question to shankarji	कहते हैं कि एक बार पार्वती जी ने शंकर जी से प्रश्न किया
lord advise a solution and place by which a living being gets relieved from several ills and sins	प्रभु ऐसा कोई उपाय और स्थान बताएँ जिससे संसार में अनेक व्याधियों और पापों से त्रस्त जीव को मुक्ति मिले
what should they do so that they get your affection	वे ऐसा क्या कर्म करें जिससे उन्हें आपका स्नेह मिले
on this shankarji said that o devi all the pilgrimages give the fruits of meritorious actions in the satayuga treta in pushkar in dwapar kurukshetra pilgrimage gives the fruits of meritorious actions and in kalikala achievements of the fruits of meritorious actions is only through the ganga bath	इस पर शंकर जी कहा कि हे देवी सतयुग में सभी तीर्थ पुण्य का फल देते हैं त्रेता में पुष्कर द्वापर में कुरुक्षेत्र तीर्थ पुण्य का फल देते हैं और कलिकाल में केवल गंगा स्नान से पुण्य फल की प्राप्ति है
there is a place called shiva ballabhpur on the banks of the ganges	गंगा तट पर शिव बल्लभपुर नामक एक स्थान है
shiva resides in the place called shiva ballabhpur	शिव बल्लभपुर नामक स्थान में शिव निवास करते हैं
shiva ballabhpur is very favorite to shivaji	शिव बल्लभपुर शिवजी को अति प्रिय है
shiva ballabhpur is located in the east direction of hastinapur in the country of aryavarta of jambudweep	शिव बल्लभपुर जम्बूद्वीप के आर्यावर्त देश में हस्तिनापुर की पूर्व दिशा में स्थित है
situated on the banks of the ganges shiva ballabhpur is satisfying to the deities sages and ancestors	गंगा तट पर बसा शिव बल्लभपुर देवों ऋषियों और पितरों को संतोष देने वाला है
shiva ballabhpur area is favorite to me like kashi	शिव बल्लभपुर क्षेत्र मुझे काशी के समान प्रिय है
the ganges temple in garh mukteshwar is built at a very great height	गढ़ मुक्तेश्वर में स्थित गंगा मंदिर काफी ऊँचाई पर बना हुआ है
besides the mother ganges temple there is also a statue of brahmaji installed in garh mukteshwar	गढ़ मुक्तेश्वर के गंगा मंदिर में गंगा मैया के अतिरिक्त ब्रह्मा जी की मूर्ति भी लगी हुई है
there is also such a stone in the ganges temple of garh mukteshwar looking closely at which the shape of lord shiva appears to be on it	गढ़ मुक्तेश्वर के गंगा मंदिर में एक ऐसा पत्थर भी है जिसे ध्यानपूर्वक देखने से उस पर भगवान शिव की आकृति का आभास होता है
at one time there used to be steps to reach the ganga temple of garh mukteshwar	गढ़ मुक्तेश्वर के गंगा मंदिर में पहुँचने के लिए कभी सीढ़ियाँ हुआ करती थीं
but now there are only steps left in the ganges temple of garh mukteshwar	किंतु गढ़ मुक्तेश्वर के गंगा मंदिर में अब सीढ़ियाँ ही बची हैं
it is said that till the ganges used to flow touching the steps of the ganges temple of garh mukteshwar	बताते हैं कि तक गंगा जी गढ़ मुक्तेश्वर के गंगा मंदिर की सीढ़ियों को छूते हुए बहती थीं
but gradually gangaji started leaving the place	लेकिन धीरेधीरे गंगा जी स्थान छोड़ती चली गईं
now the bank of the ganges is about kilometres away from this temple	अब गंगा का तट इस मंदिर से लगभग किलोमीटर दूर है
a fair is organized on the sandy fields of the banks of the ganges	गंगा तट के रेतीले मैदान में मेला लगता है
one whole city of tents gets settled on the banks during the fair	मेले के दौरान तट पर तंबुओं का एक पूरा नगर बस जाता है
the venue of the fair is about kilometres from delhi	मेला स्थल दिल्ली से लगभग किलोमीटर पड़ता है
one can easily reach the fair ground through car etcetera	मेला स्थल कार आदि से आराम से पहुँचा जा सकता है
earlier people had to go on foot to the fair venue in garh mukteshwar	गढ़ मुक्तेश्वर में पहले मेला स्थल तक लोगों को पैदल ही चलकर जाना पड़ता था
but now there are several ways of travel available	लेकिन अब यातायात के कई साधन उपलब्ध हैं
many people reach the fair venue by buggi tractor trollies cars and other resources	अनेक लोग भैंसा बुग्गी ट्रैक्टर ट्रॉलियों कार और अन्य साधनों से मेला स्थल तक पहुँचते हैं
it is estimated that every year about twenty lac people come to garh mukteshwar for holy bath in the ganges during the fair in garh mukteshwar	अनुमान है कि हर साल करीब बीस लाख लोग गढ़ मुक्तेश्वर मेले के दौरान गंगा स्नान करने आते हैं
most of the devotees coming to participate in the fair stay in the tents only	मेले में भाग लेने आए ज्यादातर श्रद्धालु लगाए गए टेंटों में ही ठहरते हैं
apart from the fair people coming during the general days stay in the dharamashalas built around the braj ghat	मेले के अलावा सामान्य दिनों में आने वाले लोग ब्रज घाट के आसपास बनी धर्मशालाओं में ठहरते हैं
as such food items are found in several shops here	यूँ तो यहाँ खानेपीने का सामान बहुत सी दुकानों में मिल जाता है
but devotees coming in the form of groups manage their food etcetera themselves	पर समूह के रूप में मेले में आने वाले श्रद्धालु अपने भोजन आदि की व्यवस्था स्वयं ही करते हैं
the fair organized on the eve of kartik poornima on the banks of the ganges in garh mukteshwar is one of the biggest fairs	कार्तिक पूर्णिमा के अवसर पर गढ़ मुक्तेश्वर में गंगा तट पर लगने वाला मेला विशालतम मेलों में से एक है
fair takes place on the banks of the ganges in an area of about kilometres	मेला गंगा के किनारे लगभग किलोमीटर के क्षेत्र में लगता है
this time the organization of fair is being done by dividing the fair venue into sectors	इस वर्ष मेले का आयोजन मेला स्थल को सेक्टरों में बाँट कर किया जा रहा है
for security reasons more police forces have been deployed in garh mukteshwar than earlier	सुरक्षा के लिहाज से गढ़ मुक्तेश्वर में पहले के मुकाबले पुलिस फोर्स ज्यादा लगाई गई है
close circuit tvs have also been installed at main places	प्रमुख स्थानों पर क्लोज सर्किट टीवी कैमरे भी लगाए गए हैं
several ghats have also been built for the bath in the ganges	गंगा स्नान के लिए अनेक घाट भी बनाए गए हैं
hastinapur has a historical importance	हस्तिनापुर का ऐतिहासिक महत्व है
jain community has special importance for all castes of north india	जैन जगत से उत्तर भारत वर्ष की सम्पूर्ण जातियों के लिए विशेष महत्व है
to go to hastinapur we considered it convenient go from the kashmiri gate bus terminus in delhi	हस्तिनापुर जाने के लिए हमने दिल्ली में कश्मीरी गेट बस अड्डे से जाना सुविधाजनक समझा
buses go continuously for meerut from kashmere gate	कश्मीरी गेट से लगातार मेरठ तक की बसें जाती हैं
then buses are found from meerut to hastinapur	फिर मेरठ से हस्तिनापुर की बसें मिल जाती हैं
the distance from delhi to hastinapur is about kilometres	दिल्ली से हस्तिनापुर की दूरी तकरीबन किलोमीटर है
hastinapur is also known by several other names in the scriptures such as gajpur nagpur asandhivat brahmasthal shantinagar kujarpur etc	हस्तिनापुर को शास्त्रों में अन्य कई नामों से भी जाना जाता है जैसे गजपुर नागपुर असंधिवत ब्रह्मास्थल शांतिनगर कुजारपुर आदि
in hastinapur shree adinath prabhu the first among the twenty four tirthankaras of jainism had ended his four hundred day fast by having juice of sugar cane from shreyansh kumar s hand	हस्तिनापुर में जैन धर्म के चौबीस तीर्थंकरों में सें सबसे पहले तीर्थंकर श्री आदिनाथ प्रभु ने अपने चार सौ दिनों के व्रत के पश्चात श्रेयंषकुमार के हाथों से गन्ने का रस ग्रहण कर अपने व्रत का समापन किया था
it was in hastinapur that twelve kalyanaks of shree shantinath prabhu kunthanath prabhu and shri arahanath prabhu occurred	हस्तिनापुर में ही श्री शांतिनाथ प्रभु कुंथनाथ प्रभु और श्री अरहनाथ प्रभु के बारह कल्याणक हुए
samosaran of bhagwan malliknath also took place in hastinapur	भगवान मल्लिनाथ का समवोशरन भी हस्तिनापुर में ही हुआ
it was in hastinapur that muni suvrat nath swami bhagwan parswanath and bhagwan mahavir swami preached in their divine voice	हस्तिनापुर में ही मुनि सुव्रत नाथ स्वामी भगवान पार्श्वनाथ और भगवान महावीर स्वामी ने अपनी दिव्य वाणी में प्रवचन दिए
the time of ablution and prayer in hastinapur is from oclock in the morning to oclock in the evening	हस्तिनापुर में प्रक्षाल और पूजाअर्चना का समय सुबह बजे से शाम बजे तक है
and the time to pray in digambar jain temple begins from seven oclock in the morning	और दिगम्बर जैन मंदिर में पूजा करने का समय सुबह सात बजे प्रारम्भ होता है
adinath bhagwan came to hastinapur four hundred days after initiation on the third light half month of baisakh	हस्तिनापुर में आदिनाथ भगवान दीक्षा लेने के सौ दिनों बाद वैशाख शुक्ल तृतीया के दिन आए थे
people from afar used to go to visit him	लोगबाग दूरदूर से उनके दर्शन के लिए जाते थे
when the prince shreyanshkumar came to know of this he remembered the tradition of his ancestors to abandon food and water	राजकुमार श्रेयंषकुमार को जब इस बात का ज्ञान हुआ तो उन्हें अपने पूर्वजों की अन्नजल त्यागने की प्रथा का स्मरण हो आया
prince shreyanshkumar urged adinatha prabhu to accept sugar cane juice for ending the fast which he accepted	राजकुमार श्रेयंषकुमार ने आदिनाथ प्रभु से व्रत के समापन के लिए इक्षु रस ग्रहण करने की प्रार्थना की जिसे उन्होंने स्वीकार किया
since then this day has started to be called as akshay tritiya	बाद में इस दिन को अक्षय तृतीया कहा जाने लगा
in hastinapur bhagwan made big kings follower of the jain religion with his preachings	हस्तिनापुर में भगवान ने अपने प्रवचनों से बड़े राजाओं को जैन धर्म का अनुयायी बनाया
out of the tirthankaras the th tirthankar shri sant suvrat swami rd tirthankar parsvanath bhagwan and the last tirthankar mahavir swami purified this place with their holy feet	तीर्थंकरो में से वें तीर्थंकर श्री मुनि सुव्रत स्वामी वें तीर्थंकर पार्श्वनाथ भगवान और अंतिम तीर्थंकर श्री महावीर स्वामी ने भी इस स्थान को अपने चरणों से पावन किया
there have been a total of supreme emperors in india	भारत में कुल चक्रवर्ती सम्राट हुए
the birth place of among the total of supreme emperors of india is hastinapur	भारत के कुल चक्रवर्ती सम्राट में से का जन्म स्थान हस्तिनापुर है
parashuram of the ramayana age was also born in hastinapur	रामायण काल के परशुराम भी हस्तिनापुर में पैदा हुए
hastinapur has been the capital of the kauravas and the pandavas	हस्तिनापुर कौरवों और पांडवों की राजधानी रह चुकी है
functions are organized on kartik full moonlight and third lighted fortnight of vaisakh in shwetambar jain temple and between kartik shukla to full moonlight in digambar jain temple	कार्तिक पूर्णिमा और वैशाख शुक्ल तृतीया को श्वेताम्बर जैन मंदिर में और कार्तिक शुक्ल से पूर्णिमा के बीच दिगम्बर जैन मंदिर में कार्यक्रम का आयोजन किया जाता है
bhagwan adinath had entrusted the states of podanpur and hastinapur to his son bahubali	भगवान आदिनाथ ने पोदनपुर और हस्तिनापुर राज्य अपने पुत्र बाहुबली को सौंप दिये थे
bahubali ruled podanpur	बाहुबली ने पोदनपुर पर शासन किया
while his son ruled hastinapur	जबकि उनके पुत्र सोमयश ने हस्तिनापुर पर
the younger brother of bahubali shreyansh kumar had performed the feet worship of adinath bhagwan	बाहुबली के छोटे भाई श्रेयंषकुमार ने आदिनाथ भगवान का चरणाभिषेक किया था
ratna stambha was built in the memory of shreyansh kumar	श्रेयंषकुमार की स्मृति में रत्न स्तम्भ बनवाया था
the charanpaduka of adinath bhagwan was also installed there	वहाँ पर आदिनाथ भगवान के चरणपादुका भी स्थापित किये थे
three pillars were also built in the memory of the four kalyanakas of shri shantinatha shri kunthanatha and arahanath bhagawana	श्री शांतिनाथ भगवान श्री कुंथनाथ भगवान और अरहनाथ भगवान के चार कल्याणक की स्मृति में भी यहाँ तीन स्तम्भ बनवाये गए
king shivraj adopted jainism after listening to the preachings of mahavir swami king shivraj built a pillar in hastinapur in the memory of mahavir swami	राजा शिवराज ने महावीर स्वामी के प्रवचन सुनकर जैन धर्म को अपनाया महावीर स्वामी की स्मृति में राजा शिवराज ने हस्तिनापुर में एक स्तम्भ बनवाया
a descendant of the emperor ashoka also got many jain temples made during his regime	सम्राट अशोक के एक वंशज ने भी अपने शासन काल के दौरान कई जैन मंदिर बनवाए
but with time those ancient pillars and temples have vanished	लेकिन समय के साथ वे प्राचीन स्तम्भ और मंदिर धीरेधीरे विलीन हो गए
this hastinapur nagar is present on the banks of the ganges	यह हस्तिनापुर नगर पवित्र गंगा के किनारे मौजूद है
management of dharamshala is also found for the stay of the people reaching hastinapur	हस्तिनापुर पहुँचे लोगों के ठहरने के लिए धर्मशाला का भी प्रबंध मिलता है
in shwetambar trust dharamshala there are rooms to stay with morning breakfast afternoon lunch and dinner at night	श्वेतांबर ट्रस्ट धर्मशाला में ठहरने के लिए कमरे और सुबह का नाश्ता दोपहर का लंच और रात के भोजन की व्यवस्था होती है
there are several other dharamashalas found easily in the same fashion	इसी प्रकार अन्य कईं धर्मशालाएँ आसानी से मिल जाती हैं
atishay kshetra tijarah one gets more than desired here	अतिशय क्षेत्र तिजारा इच्छा से ज्यादा मिलता है यहाँ
chandra prabhu digamber jain atishay kshetra dehratijara is situated in the alvar district of rajasthan	चंद्र प्रभु दिगंबर जैन अतिशय क्षेत्र देहरातिजारा राजस्थान के अलवर जिले में स्थित है
this is called atishay area	यह अतिशय क्षेत्र कहलाता है
the meaning of atishay is more than common	अतिशय का अर्थ है सामान्य से बहुत ज्यादा
that is such an area where something extraordinary occurs or some miracle happens	यानी ऐसा क्षेत्र जहाँ कुछ असाधारण घटित हो या कोई चमत्कार हो जाए
that is if something is demanded in general one gets more than that	यानी अगर साधारण तौर पर जो कुछ माँगा जाए उससे कहीं ज्यादा मिल जाए
you get so much that you get overwhelmed	इतना मिले कि आप सराबोर हो जाएँ
such is the belief of tijara area	ऐसी ही है तिजारा क्षेत्र की मान्यता
this atishay area of tijara let s say temple is situated at a distance of kilometres from alvar district and kilometers from delhi	तिजारा का यह अतिशय क्षेत्र या कहें कि मंदिर अलवर जिले से किलोमीटर और दिल्ली से किलोमीटर की दूरी पर स्थित है
the th tirthankar of the tirthankaras shree chandra prabhu bhagawan is worshipped in tijara atishay kshetra	तिजारा अतिशय क्षेत्र में तीर्थंकरों में से वें तीर्थंकर श्री चंद्र प्रभु भगवान की आराधना की जाती है
the extremely beautiful white statue of chandra prabhu bhagawan is installed in tijara atishay kshetra	तिजारा अतिशय क्षेत्र में चंद्र प्रभु भगवान की सफेद रंग की अत्यंत मनोहारी संगमरमर की मूर्ति स्थापित है
this marble statue had come out during the excavation conducted in this area on august	यह संगमरमर मूर्ति इस क्षेत्र में कराई गई खुदाई के दौरान अगस्त को निकली थी
it is said that saraswati devi the wife of a famous doctor bihari lal of tijara area had kept fast for three days	बताते हैं कि तिजारा क्षेत्र के एक मशहूर वैद्य बिहारी लाल की पत्नी सरस्वती देवी ने तीन दिन का उपवास रखा था
on the third day of the night of fast saraswati devi saw something unprecedented about a place near her house in dream	तीसरे दिन व्रत की रात को सरस्वती देवी को सपने में अपने घर के निकट स्थित एक स्थान के बारे में कुछ अद्भुत दिखाई दिया
next morning when that place was dug the grand statue of chandra prabhu bhagawan was found	अगली सुबह जब उस स्थान की खुदाई कराई गई वहाँ चंद्र प्रभु भगवान की भव्य मूर्ति प्राप्त हुई
when the statue was taken out after the excavation devotees meant this by it	खुदाई करने के पश्चात जिस समय मूर्ति निकाली गई श्रद्धालु जनों ने इसका अर्थ यह निकाला
having full joy of the nature in train while going to goa has a different fun	ट्रेन में प्रकृति का पूरा आनंद लेते हुए गोवा जाने का अलग ही मजा है
nature itself welcomed the statue with water and purified it	प्रकृति ने ही मूर्ति का जलाभिषेक करके उसे पवित्र कर दिया
several years after this incident another black color statue of chandra prabhu bhagawan in padmasan posture was found from the same place on march	इस घटना के कई वर्ष बाद उसी क्षेत्र से मार्च को चंद्र प्रभु भगवान की काले रंग की पद्मासन मुद्रा में एक अन्य मूर्ति प्राप्त हुई
this statue of chandra prabhu bhagawan had come out during the excavations of southern gate	चंद्र प्रभु भगवान की यह मूर्ति मंदिर के दक्षिणी गेट की खुदाई के दौरान निकली थी
installed in the atishay kshetra the outer structure of this temple is extremely grand	अतिशय क्षेत्र में स्थापित इस मंदिर का बाहरी स्वरूप अत्यंत भव्य है
installed in the atishay kshetra the internal decoration of this temple is very alluring	अतिशय क्षेत्र में स्थापित इस मंदिर की आंतरिक सजावट बहुत लुभावनी है
there is so much space in the courtyard of the temple that two thousand people can easily stay present here at a time	मंदिर के प्रांगण में इतनी जगह है कि एक ही बार में यहाँ दो हजार लोग आसानी से मौजूद रह सकते हैं
the train route going to goa is full of small hills and valleys	गोवा जाने का ट्रेन रूट छोटीछोटी पहाड़ियों और घाटियों से भरा पड़ा है
there is a big hall in the tijara	तिजारा में एक बड़ा हॉल है
lead work has been done on both the sides of the tijara hall	तिजारा के हॉल के दोनों ओर दीवारों पर काँच का काम किया गया है
ancient stories have been depicted through the medium of pictures on the walls of the hall in tijara	तिजारा के हॉल की दीवारों पर चित्रों के माध्यम से पौराणिक कथा उकेरी गई है
in the temple of the atishay kshetra a person prays with true heart before this statue	अतिशय क्षेत्र के मंदिर में व्यक्ति इस मूर्ति के सामने सच्चे मन से प्रार्थना करता है
it is believed that all the desires of a person is fulfilled	मान्यता है कि व्यक्ति की सभी इच्छाएँ पूरी होती हैं
people affected with witchcraft also come to tijara to get rid of their problems	जादूटोने से प्रभावित लोग भी अपनी समस्याओं के निवारण के लिए तिजारा आते हैं
an extremely attractive pillar is installed in front of the temple	मंदिर के सामने एक अत्यंत आकर्षक स्तंभ स्थापित है
this is called by the name of manstambh	इसे मानस्तंभ कहकर पुकारा जाता है
statues of deities have been installed on the top of the pillar	स्तंभ के ऊपर भगवान की मूर्तियाँ लगाई गई हैं
the statues of the deities are visible from afar	भगवान की मूर्तियों के दूर से ही दर्शन हो जाते हैं
this is called man stambh	इसे मानस्तंभ कहा जाता है
the pride of a person lessens with mere a view of the man stambh	मानस्तंभ के दर्शन मात्र से ही व्यक्ति का घमंड कम हो जाता है
general custom is that four statues of tirthankar bhagawan is installed on the top of the man stambh	सामान्य रीति यह है कि मानस्तंभ की चोटी पर तीर्थंकर भगवान की चार मूर्तियाँ स्थापित की जाती हैं
special programs are organized twice a year in tijara	तिजारा में वर्ष में दो बार विशेष कार्यक्रमों का आयोजन किया जाता है
once on the seventh day of falgun and the second time on the tenth day of shravan shukla	एक बार फाल्गुन सप्तमी को और दूसरी बार श्रावण शुक्ल दशमी को
dharmashala with rooms has been built in atishay kshetra of tijara for the lodging of devotees	तिजारा के अतिशय क्षेत्र में श्रद्धालुओं के ठहरने के लिए कमरों की धर्मशाला बनाई गई है
tijara was famous with the name of atishay kshetra dehra in ancient times	प्राचीन काल में तिजारा अतिशय क्षेत्र देहरा नाम से प्रसिद्ध था
with the change of time this place came to be known as dehra tijara and now only tijara	कालांतर में यह स्थान देहरातिजारा और अब सिर्फ तिजारा भी कहलाता है
kanker valley national park is situated kilometres south from the district headquarters of bastar	बस्तर के जिला मुख्यालय जगदलपुर से दक्षिण में किलोमीटर की दूरी पर कांकेर घाटी राष्ट्रीय उद्यान स्थित है
kanker valley national park is famous for its waterfalls caves and biodiversity	कांकेर घाटी राष्ट्रीय उद्यान अपने जलप्रपातों गुफाओं एवं जैव विविधता के लिये प्रसिद्ध है
the main tourist places of kanker valley are as follows	कांकेर घाटी के मुख्य पर्यटन स्थल निम्नानुसार हैं
the hypnotic waterfall of tirathgarh located at distance of kilometres from jagdalpur hypnotises the minds of the tourists	जगदलपुर से किलामीटर की दूरी पर स्थित तीरथगढ़ का मनमोहक जलप्रपात पर्यटकों का मन मोह लेता है
tourists lose themselves in its charming beauty	पर्यटक इसकी मोहक छटा में खो जाते हैं
one does not feel like going away from tirathgarh	तीरथगढ़ से वापिस जाने का मन ही नहीं करता
situated on the munagabahar river this waterfall falls feet down from the moon shaped hill on the ladder like natural structures	मुनगाबहार नदी पर स्थित यह जलप्रपात चन्द्राकार रूप से बनी पहाड़ी से फिट नीचे सीढ़ीनुमा प्राकृतिक संरचनाओं पर गिरता है
the milky foam formed with the fall of water and the natural fountain of drops of water wetten the tourists gradually	पानी के गिरने से बना दूधिया झाग एवं पानी की बूँदों का प्राकृतिक फव्वारा पर्यटकों को मन्दमन्द भिगो देता है
having an m tech in geology i tried to know its geological genesis	भूविज्ञान में एमटेक होने के नाते मैने इसकी भूवैज्ञानिक उत्पत्ति जानने का प्रयास किया
i found this	मैनें यह पाया
crores of years ago the rocks of the down side river formed of moonruins due to some earthquake sloped down	करोड़ो वर्ष पहले किसी भूकंप से बने चन्द्रभ्रंस से नदी के डाउन साइड की चट्टाने नीचे धसक गई थीं
and this ladder like valley would have created this charming waterfall	एवं इससे बनी सीढ़ी नुमा घाटी ने इस मनोरम जलप्रपात का सृजन किया होगा
a temple of archaeological importance is located kilometres away from tirathgarh waterfall in chingitarai	तीरथगढ़ जलप्रपात से किलोमीटर की दूरी पर पुरातात्विक महत्व का मंदिर चिंगीतराई में स्थित है
along with tirathgarh chingitarai and chandragiri have historical importance	तीरथगढ़ के साथ चिंगीतराई एवं चन्द्रगिरी ऐतिहासिक महत्व रखते हैं
it is said	ऐसा कहा जाता है
there were two sons of a king of tirathgarh estate	तीरथगढ़ रियासत के किसी राजा के दो पुत्र थे
one was prince chandradeva and the other tirathdev	एक राजकुमार चन्द्रदेव और दूसरा तीरथदेव
prince chandradeva got the area of chandragiri in inheritance	राजकुमार चन्द्रदेव को विरासत में चन्द्रगिरी का क्षेत्र मिला
it was chandradeva after the name of whom this was named as chandragiri	चन्द्रदेव के नाम पर ही इस शहर का नाम पर चन्द्रगिरी पड़ा
whereas his brother got the estate of tirathgarh	वहीं उनके भाई को तीरथगढ़ की जागीर मिली
whose name came to be tirathgarh after his name	जिसका नाम उनके नाम पर तीरथगढ पड़ गया
ruins of archaeological importance are found in chandragiri and chingitarai	चन्द्रगिरी एवं चिंगीतराई में पुरातात्विक महत्व के अवशेष प्राप्त होते हैं
natural caves of world acclaimed kotamsar are located at a distance of kilometres from jagdalpur	जगदलपुर से किलोमीटर की दूरी पर विश्व प्रसिद्ध कोटमसर की प्राकृतिक गुफाएँ स्थित हैं
the length of this longest cave of the world is metres	विश्व की सबसे लम्बी इस गुफा की लंबाई मीटर है
formed out of the dissolution of lime stones these caves are famous for the structures made from the condensation of lime stone	चूना पत्थर के घुलने से बनी ये गुफाएँ चूनापत्थर के जमने से बनी संरचनाओं के कारण प्रसिद्ध है
due to the condensation of lime stone structures like stalactite stalagmite and dripstones are formed	चूनापत्थर के जमाव के कारण स्टलेगटाइट स्टलेगमाइट एवं ड्रपिस्टोन जैसी संरचनायें बन जाती हैं
the jingle bell hanging from the roof pillar are called stalagtite those going up from the ground stalagmite and large pillars adjoining the roof and the ground are called dripstones	छत पर लटकते झूमर स्टलेगटाइट जमीन से ऊपर जाते स्तंभ स्टलेगमाइट एवं छत एवं जमीन से मिले बड़ेबड़े स्तंभ ड्रपिस्टोन कहलाते हैं
dr shankar tiwari had described this cave for the first time	डॉ शंकर तिवारी ने प्रथम बार इस गुफा का वर्णन किया था
there are small ponds located in this cave	इस गुफा में छोटेछोटे पोखर स्थित हैं
the small fish found in the caves do not have eyes	गुफाओं में पायी जाने वाली छोटीछोटी मछलियों की आँखें नहीं पायी जातीं
the utility of their eyes finished due to staying in the dark for centuries	सदियों से अंधेरे में रहने के कारण इनकी आँखों की उपयोगिता खत्म हो गई
now these fish are blind by birth itself	अब ये मछलियाँ जन्म से ही अंधी पैदा होती हैं
this validates the principles of darwin	यह डार्विन के सिद्धांत की पुष्टि करती है
kailash caves are situated at a distance of kilometres from kotamsar	कोटमसर से किलोमीटर की दूरी पर कैलाश गुफा स्थित है
its big halls give the appearance of court of a king	इसके बड़ेबड़े हॉल किसी राजा के दरबार सा भान देते हैं
the shapes of lime stone look like shivlingas	चूना पत्थर की आकृतियाँ शिवलिंग के समान जान पड़ती हैं
therefore these caves also have religious importance	इसलिये इस गुफा का धार्मिक महत्व भी है
there is a queue of devotees on the day of mahashivaratri in the kailash cave	कैलाश गुफा में महाशिवरात्रि के दिन भक्तों का तांता लगा रहता है
kailash cave is at a height of metre and is metres long	कैलाश गुफा मीटर की ऊँचाई पर तथा मीटर लम्बी है
dandak cave is at a distance of kilometres from kotamsar	दण्डक गुफा कोटमसर से किलोमीटर की दूरी पर स्थित है
like kotamasar cave the structures like stalactite stalagmite and dripstones in dandak cave give a grand look	दण्डक गुफा में भी कोटमसर गुफा के समान ही स्टलेगटाइट स्टलेगमाइट एवं ड्रपिस्टोन जैसी संरचनायें भव्य स्वरूप प्रदान करती है
in the aranyak caves attached to the kanger valley the stalagmite structures of jadhara jhanpi and makar kaksha is spectacular	कांगेर घाटी से लगी अरण्यक गुफा में जाधरा झांपी और मकर कक्ष की अवशैल संरचनाएँ देखते ही बनती हैं
the enormous hills of the kanker appear eager to welcome the bastar district while coming from raipur to jagdalpur	रायपुर से जगदलपुर आते समय बस्तर जिले का स्वागत करने कांकेर की विशाल पहाड़ियाँ तत्पर दिखाई देती है
the charming valley of keshkal starts kilometres ahead of kanker	कांकेर से किलोमीटर आगे शुरू होती है केशकाल की मनोरम घाटी
with a hairpin curve this charming valley hypnotises tourists	हेयर पिन मोड़ लिये हुये यह मनोरम घाटी पर्यटकों का मन मोह लेती है
the hills of dandakaranya starts at the end of the keshkal valley	केशकाल घाटी के अंत में शुरू होता है दण्डकारण्य का पठार
the pleasant scene of keshkal valley is seen from the rest house and watch tower of panchavati	पंचवटी के विश्रामगृह एवं वाचिंग टावर से केशकाल घाट का मनोरम दृश्य दिखाई पड़ता है
suddenly one does not feel that we are seeing the views of plain areas	एकाएक तो यह एहसास ही नहीं होता कि हम मैदानी क्षेत्र के दृश्यों को देख रहे हैं
mountain ranges are spread far and wide	दूरदूर तक पर्वत मालाएँ फैली हैं
beautiful earth wrapped in green shawl flocks of clouds clashing with the mountains make us feel like the himalayas	हरी चादर में लिपटी सुन्दर वसुन्धरा बादलों के पर्वतों से टकराते झुण्ड हमें मानों हिमालय पर्वत सा एहसास कराते हैं
the actual border of bastar starts from here	बस्तर की वास्तविक सीमा यहीं से शुरू होती है
one has to go through geedam to reach barsur located at a distance of kilometres from jagdalpur the sadar destination of bastar	बस्तर के सदर मुकाम जगदलपुर से किलोमीटर की दूरी पर स्थित बारसूर तक पहुँचने के लिये गीदम से होकर जाना पड़ता है
barsur is situated kilometres away from geedam	बारसूर गीदम से किलोमीटर की दूरी पर स्थित है
there is huge statue of lord ganesha here	यहाँ गणेश जी की विशाल मूर्ति है
barsur has been the capital of nag kings and kakatiya administrators	बारसूर नाग राजाओं एवं काकतीय शासकों की राजधानी रहा है
barsur is famous for temples of the eleventh and the twelfth centuries	बारसूर ग्यारहवीं एवं बारहवीं शताब्दी के मंदिरो के लिए प्रसिद्ध है
among the temples of barsur the mamabhanja temple is basically a shiva temple	बारसूर के मंदिरों में मामाभांजा मंदिर मूलत शिवमंदिर है
mamabhanja temple has two sanctum sanctorum	मामाभांजा मंदिर दो गर्भगृह युक्त मंदिर है
the mandapas of mamabhanja temples are adjoined	मामाभांजा मंदिर के मंडप आपस में जुड़े हुये हैं
depiction of copulating statues are also found in the dilapidated temples of barsur	बारसूर के भग्न मंदिरों में मैथुनरत प्रतिमाओं का अंकन भी मिलता है
according to historian and renowned educationist dr jha this town was known with name of vaivashwatpur in ancient times	इतिहासकार एवं विख्यात शिक्षाविद डॉकेके झा के अनुसार यह नगर प्राचीन काल में वेवश्वतपुर के नाम से जाना जाता था
chandraditya temple was built by the naga king chandradita and it is after his name that this temple is known	चन्द्रादित्य मंदिर का निर्माण नाग राजा चन्द्रादित्य ने करवाया था एवं उन्हीं के नाम पर इस मंदिर को जाना जाता है
the battisa temple standing on thirty two pillars has been built with sand stone	बत्तीस स्तंभों पर खड़े बत्तीसा मंदिर का निर्माण बलुआ पत्थर से हुआ है
mundamahadevi built the battisa temple during the regime of someshwar dev	बत्तीसा मंदिर का निर्माण गुण्डमहादेवी ने सोमेश्वर देव के शासन काल में किया
there are beautiful statues of shiva and nandi in the battisa temple	बत्तीसा मंदिर में शिव एवं नंदी की सुन्दर प्रतिमायें हैं
this thousand year old battisa temple has been built by organizing stones in a very scientific manner	एक हजार साल पुराने इस बत्तीसा मंदिर को बड़े ही वैज्ञानिक तरीके से पत्थरों को व्यवस्थित कर बनाया गया है
these temples are protected monuments by the archaeology department	ये मंदिर आरकियोलाजी विभाग द्वारा संरक्षित स्मारक हैं
two huge statues of lord ganesha built with sand stone are surprising	गणेश भगवान की दो विशाल बलुआ पत्थर से बनी प्रतिमायें आश्चर्यचकित कर देती हैं
mamabhanja temple is excellent in view of the sculpture and worth visit	मामाभांजा मंदिर शिल्प की दृष्टि से उत्कृष्ट एवं दर्शनीय है
the vishnu temple of narayanpal was built by queen gundamahadevi of king dharavarsha of chhindak nag dynasty about kilometres away from jagdalpur in the bastar developmental block of bastar district	बस्तर जिले के विकास खण्ड बस्तर में जगदलपुर से करीब किलोमीटर दूर छिंदक नागवंशी राजा धारावर्षा की रानी गुण्डमहादेवी द्वारा नारायणपाल के विष्णु मंदिर को ईसन् में बनवाया गया
the son gundamahadevi someshvar dev was an influential king	गुण्डमहादेवी का पुत्र सोमेश्वर देव एक प्रतापी राजा था
by the completion of the vishnu temple of narayanpal dharavarsha and someshwar dev had died	नारायणपाल के विष्णु मंदिर के पूर्ण होतेहोते धारावर्षा एवं सोमेश्वर देव दिवंगत हो चुके थे
and there was the regime of chhindak nagvanshi king kanhar dev the grand son of gundamahadevi	एवं गुण्डमहादेवी के पौत्र छिंदक नागवंशी राजा कन्हर देव का शासन था
the inscriptions of gundamahadevi and her daughterinlaw the queen of king kanhar dev are here	गुण्डमहादेवी और उसकी बहू सोमेश्वर देव की रानी के शिलालेख यहाँ पर हैं
this vishnu temple of narayanpal is a protected monument by the archaeological department	नारायणपाल का यह विष्णु मंदिर पुरातत्व विभाग द्वारा संरक्षित स्मारक है
this vishnu temple of narayan pal is also the main source collecting information of the period of regime of chhindak nag dynasty	नारायण पाल का यह विष्णु मंदिर छिंदक नागवंशी शासन के समय की जानकारी प्राप्त करने का मुख्य स्त्रोत भी है
situated at the confluence of the shankhini and the dankini rivers dantewada is at a distance of kilometres from jagdalpur	शंखनी एवं डंकनी नदी के संगम स्थल पर स्थित दण्तेवाड़ा जगदलपुर से किलोमीटर की दूरी पर स्थित है
the ancient temple of the deity of bastar ma danteshwari devi is here	यहाँ बस्तर की आराध्य देवी माँ दंतेश्वरी देवी का प्राचीन मंदिर है
danteshwari devi is the symbol of the residents of bastar	दंतेश्वरी देवी बस्तर के रहवासियों की आस्था का प्रतीक है
during dashahra tourists of the world come to bastar	दशहरे के समय देशविदेश के पर्यटक बस्तर आते है
for the devotees coming on foot the facilities of free food breakfast lodging and medical treatment is made available by volunteer organizations	पैदल चलकर आने वाले श्रद्धालुओं के लिये विभिन्न स्वयं सेवी संस्थाओं के द्वारा निशुल्क भोजन नास्ते रहने एवं चिकित्सा सुविधा उपलब्ध करायी जाती है
besides the statue of danteshwari maai the statues of shiva ganesha the sun bhairava are also in bastar	बस्तर में दण्तेश्वरी माई के अलावा शिव गणेश विष्णु सूर्य भैरव की प्रतिमाएँ हैं
these statues are also important from the archaeological point of view	ये प्रतिमाएँ पुरातात्विक दृष्टि से भी अत्यंत महत्वपूर्ण हैं
watching the excavation of iron ore in bailadila is also a grand experience	बैलाडीला में लौह अयस्क का खनन देखना भी अद्भुत अनुभव होता है
mines of n are in bacheli and kirandool	बचेली एवं किरंदूल में एनएमडीसी की खदाने हैं
one can stay in the guest house in bailadila	बैलाडीला में गेस्ट हाऊस में रुका जा सकता है
getting permission is mandatory to visit the mines of iron ore in bailadila	बैलाडीला में लौह अयस्क की खदानों को देखने के लिये अनुमति लेना आवश्यक है
the mines of bacheli are kilometres away from the township	बचेली की खदानें टाउनशिप से किलोमीटर दूर हैं
the ores of bacheli are considered to be good grade	बचेली का अयस्क अच्छे ग्रेड का माना जाता है
the percentage of iron in the ores of bacheli is up to	बचेली के अयस्क में लोहे का प्रतिशत तक रहता है
k railway line kotsavalya to kirandool	केके रेलवे लाइन कोत्सावल्या से किरन्दूल
it is a romantic experience to travel by the passenger in k railway line	केकेरेलवे लाइन में पेसेंजर से सफर करना एक रोमांचक अनुभव होता है
on the way the train passing through the dense forest and skytouching hills taking uturn and mountains peeping through the clouds present a hypnotising scene	रास्ते में घने जंगल एवं गगनचुम्बी पहाड़ियों के बीच से गुजरती ट्रैन यूटर्न लेती ट्रैन एवं बादलों के बीच से झाँकते पहाड़ मनमोहक दृश्य उपस्थित करते हैं
the kind of biodiversity seen in bastar is not found anywhere else	जो जैवविविधता बस्तर में दिखलाई पड़ती है वह अन्यत्र देखने को नहीं मिलती
in the adventurous journey to bastar falls shimliguda the highest broad gauge railway station of asia	बस्तर के रोमांच भरे सफर में एशिया का सबसे ऊँचा ब्राड गेज रेलवे स्टेशन शिमलीगुड़ा पड़ता है
sellers of the juicy fruits of palm are found throughout the way	ताड़ी के रसभरे फल लेकर बेचने वाले पूरे रास्ते में मिलते हैं
it feels good to eat juicy fruits of palm	ताड़ी के रसभरे फलों को खाना अच्छा लगता है
in this adventurous journey the train running with two electronic engines pass through tunnels	इस रोमांचकारी सफर में दो इलेक्ट्रिक इंजनों से चलने वाली ट्रैन बोगदों टनल से होकर गुजरती है
the length of k line is to metres	केके लाइन की लम्बाई से मीटर तक है
the japanese had done the construction of k line to take the iron ore or bailadila to japan through vishakhapatnam	केके लाइन का निर्माण जापानियों ने बैलाडीला के लौह अयस्क को विशाखापटनम होते हुए जापान ले जाने के लिये किया था
from vishakhapatnam the iron ore was taken to japan by ships	विशखापटनम से लौह अयस्क पानी के जहाज से जापान ले जाया जाता है
food items are not found in the journey of k line	केके लाइन के सफर में खाने पीने की सामग्री नहीं मिलती
therefore if you want to enjoy this journey take enough amount of food items along	अत यदि इस सफर का आनंद लेना हो तो खानेपीने की भरपूर सामग्री साथ लेकर चलना चाहिए
k line has been transporting iron ore since the last years	केके लाइन विगत वर्षों से लोह अयस्क का परिवहन कर रही है
on an average goods train run on the k line everyday	औसतन मालगाड़ियाँ केके रेलवे लाइन पर प्रतिदिन चलती हैं
by transporting iron ore on the kilometres long k railway line the railways gets a profit of about billion every year	किलोमीटर लम्बे इस केके रेलवे लाइन से लौह अयस्क परिवहन कर रेलवे को प्रतिवर्ष लगभग बिलियन का फायदा होता है
the world famous chitrakot waterfall is located at a distance of kilometres from jagdalpur	जगदलपुर से किलोमीटर की दूरी पर विश्वप्रसिद्ध चित्रकोट जलप्रपात स्थित है
having expanded in chitrakot the indravati river forms the charming waterfall	चित्रकोट में इन्द्रावती नदी विस्तारित होकर मनमोहक जलप्रपात का निर्माण करती है
chitrakot waterfall is also called the niagara of bastar	चित्रकोट जलप्रपात को बस्तर का नियाग्रा भी कहा जाता है
watching the chitrakot waterfall in flood lights provides quite a different kind of experience	फ्लड लाइट में जलप्रपात को देखना अलग ही अनुभव प्रदान करता है
the joy of staying in the fully furnished hut of the tourism department is quite different	पर्यटन विभाग की पूर्ण सुविधा संपन्न हट में रुकने का आनंद ही अलग है
the tamraghumad waterfall is at a distance of kilometres from the chitrakot waterfall	चित्रकोट जलप्रपात से किलोमीटर की दूरी पर तामड़ाघुमड़ जलप्रपात है
in tamraghumad waterfall rivulet falling from a height of feet forms a pleasant waterfall	तामड़ाघुमड़ जलप्रपात में एक छोटी सरिता सीधे लगभग फिट की ऊँचाई से निचले भाग में गिरकर एक मनोरम जलप्रपात का निर्माण करती है
it is good to see the waterfall by climbing down	प्रपात को नीचे से उतरकर देखना अच्छा लगता है
as the road of going down is difficult it becomes necessary to take extra caution	उतरने का मार्ग दुर्गम होने के कारण अतिरिक्त सावधानी रखना आवश्यक होता है
there is a pleasant place located in the heart of jagdalpur	जगदलपुर के हृदयस्थल में स्थित एक मनोरम स्थान है
children s park and train are available here	यहाँ बच्चों के लिये बाल उद्यान एवं रेलगाड़ी की व्यवस्था है
along with this a large skating ring attracts the youths	साथ ही एक विशाल स्केटिंग रिंग युवाओं को आकर्षित करती है
beautiful lawns and flower parks hypnotise the tourists	सुन्दर लॉन एवं पुष्प उद्यान पर्यटकों का मन मोह लेते हैं
built by the great king purushottam dev of the kakatiya dynasty this pond has the pride of being the largest pond of chhattisgarh	काकतीय वंश के महाराजा पुरूषोत्तम देव द्वारा बनाये गये इस तालाब को छत्तीसगढ़ के सबसे बड़े तालाब होने का गौरव प्राप्त है
this is suitable place for morning and evening walks	प्रात एवं सांयकालीन भ्रमण के लिये यह उपयुक्त स्थान है
the facility of tour with paddle boat along with motorboat is available in the island formed in the pond	तालाब में बने आइलैण्ड में मोटरबोट के साथ पैडलबोट से सैर की सुविधा उपलब्ध है
the windmill installed in the island also attracts	आइलैण्ड में लगी पवन चक्की भी आकर्षित करती है
on the main gate of the palace of bastar there is the temple of the deity of bastar maa danteshwari	बस्तर के राजमहल के मुख्य द्वार पर बस्तर की आराध्य देवी माँ दण्तेश्वरी का मंदिर है
along with the temple the large chariot running during dashahara can also be seen at its gate	मंदिर के साथ दशहरे पर चलने वाले विशाल रथ भी इसके द्वार पर देखे जा सकते हैं
the statue of the last great king pravirchandra bhanjadeva of the kakatiya dynasty of bastar in front of the danteshwari temple is a symbol of faith the bastar residents	दण्तेश्वरी मंदिर के सामने बस्तर के काकतीय वंश के अंतिम महाराजा प्रवीरचन्द्र भंजदेव की प्रतिमा बस्तर वासियों की आस्था का प्रतीक है
the grand temple of lord balaji is on the dharampura road	धरमपुरा रोड पर भगवान बालाजी का भव्य मंदिर है
devotees from not only the state but other parts of the country also come to visit in the temple of balaji of dharampura road	धरमपुरा रोड के बालाजी के मंदिर में प्रदेश ही नहीं वरन देश के अन्य भागों से भी श्रद्धालु दर्शन करने आते हैं
the state of kerala is very popular among tourists	केरल प्रांत पर्यटकों में बेहद लोकप्रिय है
that is why kerala is called god s own country	इसीलिए केरल को अर्थात् ईश्वर का अपना घर नाम से पुकारा जाता है
there are several types of visiting places in kerala	केरल में अनेक प्रकार के दर्शनीय स्थल हैं
main among the important visiting places of kerala are	केरल के प्रमुख दर्शनीय स्थलों में प्रमुख हैं पर्वतीय तराइयाँ समुद्र तटीय क्षेत्र अरण्य क्षेत्र तीर्थाटन केन्द्र आदि
innumerous tourists from the world over come for tour to these places	इन स्थानों पर देशविदेश से असंख्य पर्यटक भ्रमणार्थ आते हैं
mountainous areas like munnar nelliyanpati ponmuti etc sea coasts like kovalam warkala cherayi etc wildlife centres like periyar iravikulam etc are the centres of attraction for kollam and alapuzha	मुन्नार नेल्लियांपति पोन्मुटि आदि पर्वतीय क्षेत्र कोवलम वर्कला चेरायि आदि समुद्र तट पेरियार इरविकुळम आदि वन्य पशु केन्द्र कोल्लम अलप्पुष़ा के लिए विशेष आकर्षण केन्द्र हैं
among indian medical systems ayurveda also has an important contribution in the area of tourism	भारतीय चिकित्सा पद्धति में आयुर्वेद का भी पर्यटन के क्षेत्र में महत्वपूर्ण योगदान है
tourism has played a defining role in the economy of the state	राज्य की आर्थिक व्यवस्था में भी पर्यटन ने निर्णयात्मक भूमिका निभाई है
daman and diu are also among the national territories of india	भारत के केन्द्रशासित प्रदेशों में दमन और दीव भी है
unfathomable waters of the arabian sea have made them main centres of trade and tourism	अरब सागर की अपारअगाध जलराशि ने इन्हें व्यापार और पर्यटन का प्रमुख केन्द्र बना दिया है
there are several small islands in daman and diu	दमन और दीव में बहुत छोटेछोटे द्वीप हैं
natural beauty mix of diverse cultures and beautiful sea coasts has gifted abundant beauty to daman and diu	प्राकृतिक सुंदरता विविध संस्कृतियों का मेल व सुंदर समुद्र तटों ने दमन और दीव को असीम खूबसूरती से नवाजा है
nearness of the states of gujarat and maharashtra has given the tourism here a full opportunity to flourish	गुजरात व महाराष्ट्र राज्य की नजदीकी ने यहाँ के पर्यटन को फलनेफूलने का पूरा मौका दिया है
for a long time daman and diu were governed by the portuguese	बहुत समय तक दमन और दीव पर पुर्तगालियों का शासन था
after that having become independent of the portuguese daman and diu were merged with goa	उसके बाद पुर्तगालियों से आजाद कराकर दमन और दीव को गोआ में मिला दिया गया
in daman and diu were given the status of a separate national territory	वर्ष में दमन और दीव को एक अलग केन्द्रशासित प्रदेश का दर्जा दिया गया
the distance of daman from mumabi the main trade center of india is about kilometres	भारत के प्रमुख व्यावसायिक केन्द्र मुंबई से दमन की दूरी लगभग किमी है
daman is attached to the state of gujarat in the east and the arabian sea in the west	दमन पूर्व में गुजरात राज्य से तथा पश्चिम में अरब सागर से जुड़ा है
in the north of daman is kolak and in the south kalai river	दमन के उत्तर में कोलाक तथा दक्षिण में कलाई नदी है
the neighbor district of daman is the valsad district of gujarat	दमन का पड़ोसी जिला गुजरात का वलसाड जिला है
diu is such an island of india which is attached with two bridges	दीव भारत का एक ऐसा द्वीप है जो दो पुलों के द्वारा जुड़ा है
diu is joined with junagarh district of gujarat	दीव गुजरात के जूनागढ़ जिले से जुड़ा है
daman is divided into two as motidaman and nanidaman	दमन दो भागों में मोटी दमन और नानी दमन में विभाजित है
the river dividing daman into two parts is damanganga river	दमन के दोनों भागों को विभक्त करने वाली नदी दमनगंगा नदी है
there are several old churches in motidaman among which the main church is the cathedral bom jesus	मोटी दमन में कई पुराने चर्च हैं जिनमें प्रमुख चर्च कैथेडरल बोल जेसू है
the paintings related to the life of jesus the messiah on the walls of the churches of daman and the fine carvings on the wood draw the tourists here	दमन के चर्च की दीवारों पर की गई ईसा मसीह के जीवन से संबंधित सुंदर चित्रकारी व लकड़ी की बेहतरीन नक्काशी पर्यटकों को यहाँ खींच लाती है
the main attraction of nanidaman is the saint jerome fort	नानी दमन का मुख्य आकर्षण संत जैरोम का किला है
the jerome fort of daman was built for defense from the attacks of the mughals	दमन का जैरोम किला मुगलों के आक्रमण से सुरक्षा के लिए बनाया गया था
besides this among other tourist attractions of daman are bom jesus church our lady of the church our lady of remidio s church pargoal garden amusement park damanganga tourist complex kachigam satya sagar udyan mirasol garden mirasol water park etc	इसके अलावा दमन के अन्य पर्यटक आकर्षणों में बोम जीजस चर्च अवर लेडी ऑफ सी चर्च अवर लेडी ऑफ रेमीडियोज चर्च परगोला गार्डन अम्यूजमेंट पार्क दमनगंगा टूरिस्ट कॉम्प्लेक्स काचीगाम सत्य सागर उद्यान मिरासोल गार्डन मिरासोल वाटर पार्क आदि हैं
the arabian sea touching the lands of daman has provided daman with unique natural beauty and greenery	दमन की जमीन को छूते अरब सागर ने दमन को अप्रतिम प्राकृतिक सुंदरता व हरियाली प्रदान की है
there are two beaches in daman devika beach and the jampore beach	दमन में दो बीच देविका बीच और जैमपोरे बीच हैं
devika beach is five kilometres north from daman	देविका बीच दमन से पाँच किमी उत्तर में है
devika beach very much lures the children because there are parks for the children and other facilities here	देविका बीच बच्चों को बहुत लुभाता है क्योंकि यहाँ बच्चों के लिए पार्क व अन्य सुविधाएँ हैं
located in nanidaman jampore beach is a famous picnic spot also	नानी दमन में स्थित जैमपोरे बीच दमन का प्रसिद्ध पिकनिक स्पॉट भी है
the peaceful environment of jampore draws lovers to jampore beach	जैमपोरे बीच का शांत वातावरण प्रेमियों को खींच लाता है
because of peaceful environment of jampore beach most of the loving couples come here in search of freedom	जैमपोरे बीच के शांत वातावरण के कारण अधिकांश प्रेमी जोड़े यहाँ स्वच्छंदता की तलाश में आते हैं
jampore beach is a very good place for swimming also	तैराकी के लिए भी जैमपोरे बीच बहुत अच्छा स्थान है
what is there in the island	क्या है दीव में
saint paul church diu fort panikota fort ghogala beach children s park and summer house are chief tourist places of diu	सेंट पॉल चर्च दीव फोर्ट पनीकोटा फोर्ट घोघला बीच चिल्ड्रन पार्क और समर हाउस दीव के मुख्य पर्यटन स्थल हैं
nagoa beach is an extremely beautiful beach of diu	नगोआ बीच दीव का बेहद ही सुंदर बीच है
you can easily reach nagoa beach after a minute drive from diu	दीव से मिनट की ड्राइव करके आप आसानी से नगोआ बीच पहुँच सकते हैं
due to being in the shape of a shoe the nagoa island spread in k has now become the first choice of tourists	जूते के आकार के समान होने के कारण किमी तक फैला नगोआ द्वीप अब पर्यटकों की पहली पसंद बन रहा है
chakratirtha beach is rich with the beauty of greenery	चक्रतीर्थ बीच हरियाली के सौंदर्य से भरपूर है
beautiful gardens near the chakratirtha beachand an open stadium make it a place of full enjoyment for the tourists	चक्रतीर्थ बीच के आसपास स्थित सुंदर बगीचे खुला स्टेडियम इसे पर्यटकों के लिए फुल इंजॉयमेंट का स्थान बनाता है
when to go to daman and diu	कब जाएँ दमन और दीव
although the climate of daman and diu attracts tourists throughout the year but suitable season to come here is from october to may	वैसे तो दमन और दीव की जलवायु वर्षभर पर्यटकों को आकर्षित करती है किंतु यहाँ आने का उपर्युक्त मौसम अक्टूबर से मई तक का है
how to reach daman and diu	कैसे पहुँचें दमन और दीव
daman has kilometres of road and the road in diu is up to kilometres long	दमन में किमी का सड़क मार्ग है तथा दीव में किमी तक लंबा सड़क मार्ग है
daman is situated on the delhimumbai route of the western railway	दमन पश्चिम रेलवे के दिल्लीमुंबई रूट पर स्थित है
the nearby railway station of daman is vapi of gujarat	दमन का नजदीक दमन रेलवे दमन स्टेशन दमन गुजरात दमन का वापी है
diu is attached with metre gauge railway line	दीव मीटर दमन गेज दमन रेलवे दमन लाइन दमन से जुड़ा है
the nearby railway station of diu is dilwada	दीव दमन का नजदीकी दमन रेलवे दमन स्टेशन दमन दिलवाड़ा है
daman and diu both are attached to airport	दमन और दीव दोनों एयरपोर्ट से जुड़े हैं
several flights take off for mumbai from diu	दीव से मुंबई के लिए रोजाना कई उड़ानें भरी जाती हैं
the main centres of temple building activities of rajasthan	राजस्थान के मंदिर निर्माण गतिविधियों निर्माण के प्रमुख केन्द्र
temple building activities in udaipur area of mewar	मेवाड़ उदयपुर क्षेत्र में मंदिरनिर्माण गतिविधियाँ
in comparison with vishnu and shiva the worship of shakti was more popular in the postgupta period mewar	उत्तर गुप्तकाल में मेवाड़ क्षेत्र में विष्णु एवं शिव की अपेक्षा शक्ति पूजा अधिक प्रचलित थी
temples built at places like jagat and unwas are powerful examples of the popularity of shakt sect	जगत और उनवास जैसे स्थानों पर बने मंदिर शाक्त संप्रदाय की लोकप्रियता के सशक्त उदाहरण हैं
in the temples of jagat and unwas the mahishamardini form of durga has been glorified	जगत और उनवास के मंदिरों में दुर्गा के महिषमर्दिनी रूप को महिभान्वित किया गया है
among the people of vaishnava sect laxminarayan and varaha forms of vishnu were specially worshipped	वैष्णव संप्रदाय के लोगों के बीच विष्णु के लक्ष्मीनारायण और वराह विग्रहों की पूजा विशेष रूप से होती थी
built temples of gods of shiva and the sun are found very rarely in the mewar udaipur region	मेवाड़ उदयपुर क्षेत्र में शिव एवं सूर्य देवताओं के बने मंदिर अत्यंत कम प्राप्त होते हैं
the renowned places for temple building activities of the mewar province are being described	मेवाड़ प्रान्त के मंदिर निर्माण गतिविधियों के लिए प्रसिद्ध क्षेत्रों का उल्लेख किया जा रहा है
the oldest vaishnav and sun temples in mewar were built in chittorgarh	मेवाड़ में सबसे प्राचीन वैष्णव एवं सौर मंदिरों का निर्माण चित्तौड़गढ़ में हुआ था
political and religious history and geographical location of fort have influenced the building and renovation of temples	दुर्ग के राजनीतिक एवं धार्मिक इतिहास तथा भौगोलिक परिवेश ने मंदिरों के निर्माण एवं जीर्णोद्धार को प्रभावित किया है
with the archival and archaeological evidences it is found that from second century b till seventh century a vaishnav religion was popular in this region	अभिलेखीय एवं पुरातात्विक प्रमाणों द्वारा यह ज्ञात होता है कि ईसवी पूर्व द्वितीय शताब्दी से सातवीं शताब्दी तक इस क्षेत्र में वैष्णव धर्म लोकप्रिय था
besides this in mewar evidences of several ancient pilgrimage related to the religions of shaiv shakta saur buddhists and jains are found	इसके अलावा मेवाड़ में शैव शाक्त सौर बौद्ध व जैन धर्मों से संबद्ध भी कई प्राचीन तीर्थस्थल के प्रमाण मिलते हैं
the statues of meditating buddha are depicted on the crevices of the wall on all the four sides of some daan stupas of th th century	वीं वीं सदी के मिले कुछ दान स्तूप जिनका आधार वर्गाकार है के चारों ओर की ताखों में ध्यान मुद्रा में बैठे हुए बुद्ध की प्रतिमाएँ अंकित हैं
apart from this temples of th century are found as well	इसके अलावा भी वीं सदी के कई मंदिर मिलते हैं
during the difference of th to th century chittor was continuously the main center of activities like temple building and other sculpting renovation etcetera	वीं से वीं सदी के अंतराल में चित्तौड़ निरंतर मंदिर एवं अन्य वास्तु निर्माण जीर्णोद्धार आदि गतिविधियों का प्रमुख केन्द्र था
in this period the regime of maharana kumbha is specially notable for these activities	इस अवधि में महाराणा कुंभा का राज्यकाल ई इन गतिविधियों के लिए विशेष उल्लेखनीय है
materials used for construction were brought from nagari	भवननिर्माण के लिए उपयोग में आने वाली सामग्री नागरी से लायी जाती थी
the abundance of available stones also has influenced the architecture in the mewar region	उपलब्ध पाषाणों की प्रचुरता ने भी मेवाड़ क्षेत्र में वास्तुनिर्माण को प्रभावित किया है
some main temples of mewar are being described thus	मेवाड़ के कुछ प्रमुख मंदिरों की चर्चा इस प्रकार की जा रही है
kalika mata mandir was basically a sun temple	कालिका माता मंदिर मूलतः एक सूर्य मंदिर था
based on the archival evidence the kalika mata mandir can be ascertained to be of the initial period of th century	अभिलेखीय प्रमाण के आधार पर कालिका माता मंदिर को वीं शताब्दी के प्रारंभिक काल का निश्चित किया जा सकता है
kalika mata mandir was renovated in time	कालिका माता मंदिर का समयांतर में जीर्णोद्धार किया गया
pancharath sanctum sanctorum mandap abhyantariya pradakshina path and dwarmandap are built in kalika mandir	कालिका माता मंदिर में पंचरथ गर्भगृह मंडप आम्यन्तरीय प्रदक्षिणा पथ और द्वारमंडप निर्मित हैं
statues of chariot riding sun god is honourably installed in two of the three main crevices of the sanctum sanctorum while in minor crevices the statues of chandra and other direction gods are carved	गर्भगृह की बाह्य तीनों प्रमुख ताखों में से दो में रथारुढ़ सूर्यदेव की प्रतिमाएँ प्रतिष्ठित हैं जबकि गौण ताखों में चन्द्र तथा अन्य दिक्पालों की प्रतिमाएँ उत्कीर्ण हैं
the decoration of the arch and threshold of the entrance of the sanctum sanctorum is specially notable	गर्भगृह के प्रवेश द्वार का सिरदल एवं चौखट का अलंकरण विशेष रूप से उल्लेखनीय हैं
on both sides of the threshold the goddesses of the ganges and the yamuna river seated on their carriers are carved	चौखट पर दोनों ओर गंगा तथा यमुना नदी देवियाँ अपने वाहनों पर आरुढ़ अंकित की गई है
kurmavatar umamaheshwar and lakulish statues carved in the temple indicate the initial stage of sculpture	मंदिर में अंकित कूर्मावतार उमामाहेश्वर तथा लकुलीश मूर्तियाँ प्रतिमा विज्ञान की प्रारंभिक अवस्था को इंगित करता है
kurmavatar umamaheshwar and lakulish statues carved in the temple later achieve maturity	मंदिर में अंकित कूर्मावतार उमामाहेश्वर तथा लकुलीश मूर्तियाँ बाद में प्रौढ़ता प्राप्त कर लेते हैं
the top of the temple is a completely new construction	मंदिर का शिखर पूर्णतः नवीन रचना है
in place of th century arch style dome like new top has been built	वीं शताब्दी की शिखर शैली के स्थान पर गुंबदाकार नया शिखर बनाया गया है
two half pictures and one lakulish statue attached on the internal wall of the canopy seem to be installed later	मंडप की आम्यंतरीय भित्ति पर लगी दो अर्द्धचित्र तथा एक लकुलीश प्रतिमा बाद में लगाई गई लगती है
in fact the original place of these rock plates would have been on the platform of the temple	वस्तुतः इन शिलापट्टों का मूल स्थान मंदिर की जगती पर रहा होगा
the subject matter of the half picture plates is dance music and drinking	अर्द्धचित्र पट्टों की विषयवस्तु नृत्य संगीत एवं पान गोष्ठी है
basically the temple was built on a large platform	मूलतः मंदिर एक विशाल जगती पर बना था
some constituents of the large platform of the temple are still left	मंदिर की विशाल जगती के कुछ गढ़ने अभी भी शेष हैं
for communication of light and air in the circumambulation path of the sanctum sanctorum two ventilators on four pillars have been built	गर्भगृह के प्रदक्षिणापथ में प्रकाश एवं वायु संचार के लिए दो भद्रावलोकन चार स्तंभों पर बनाये गये हैं
kumbhaswami or kumbhashyam was originally a vaishnav temple	कुंभस्वामी या कुंभश्याम मंदिर मूलतः वैष्णव मंदिर था
according to the kirti stambha edicts renovation of the kumbhaswami or kumbhashyam temple was done by king kumbhakarna maharana kumbha	कीर्ति स्तंभ प्रशस्ति के अनुसार कुंभस्वामी या कुंभश्याम मंदिर का जीर्णोद्धार नृपति कुंभकर्ण महाराणा कुंभा के द्वारा करवाया गया था
due to renovation being done by maharana kumbha it started to be known with the names like kumbhaswami and kumbhashyam etc	महाराणा कुंभा के द्वारा जीर्णोद्धार किए जाने के कारण इसे कुंभस्वामी और कुंभश्याम जैसे नामों से जाना जाने लगा
this temple is contemporary of the kalika mata temple and its architecture planning and style also matches with it	यह मंदिर कालिका माता मंदिर का ही समकालीन है तथा इसकी वास्तु योजना तथा शैली भी इससे मिलतीजुलती है
on the one side where the architecture plan of the temple prominent and blank back undecorated thighs and circumambulation path the god statues of the outer crevices of the sanctum sanctorum seem to be a construction of th century	एक तरफ जहाँ मंदिर की वास्तु योजना उन्नत एवं सादी पीठ अलंकरण रहित जंघा एवं प्रदक्षिणापथ गर्भगृह के बाह्य ताखों की देव प्रतिमाएँ तथा अंतराल के अर्द्धस्तंभों की प्रतिमाएँ वीं सदी की रचना प्रतीत होती है
due to being built in different periods this temple of kumbhaswamy has cherished several examples of architecture styles and statue crafts	कुंभस्वामी का यह मंदिर विभिन्न कालों में निर्मित होने के कारण कई वास्तु शैलियों एवं मूर्ति शिल्पों का उदाहरण संजोये हुए है
according to shri dhaki it was king manbhanga who built this temple also	श्री ढाकी के अनुसार राजा मानभंग ने ही इस मंदिर का भी निर्माण किया
king manbhanga has the credit of building the temples like kalika mata sun temple the nearby tadaga and tripurvijaya prasada etc	राजा मानभंग को कालिका माता सूर्य मंदिर निकटवर्टी तड़ाग तथा त्रिपुरविजय प्रासाद आदि के निर्माण का श्रेय है
according to shri dhaki the kumbhaswamin alam of the kirtistambha edict was the ancient tripur vijaya	श्री ढाकी के अनुसार कीर्तिस्तंभ प्रशस्ति का कुंभस्वामिन आलम प्राचीन त्रिपुर विजय ही था
kumbha had rebuilt the ancient tripur vijaya kumbhaswamin alam	कुंभस्वामिन आलम प्राचीन त्रिपुर विजय को कुंभा ने फिर से निर्मित किया था
the seminary canopy of the present kumbhashyam temple has been rebuilt with the ancient ruins and new stones	वर्त्तमान कुंभश्याम मंदिर का सभामंडप फिर से प्राचीन अवशेषों और नवीन पाषाणों द्वारा बनाया गया है
new vaishnava statues have been installed instead of old dilapidated shaiva statues	मूल खंडित शैव मूर्तियों के स्थान पर नई वैष्णव मूर्तियाँ स्थापित कर दी गई हैं
protected shaiva temples have been kept as it is	सुरक्षित शैव मूर्तियों को पूर्ववत् ही रखा गया है
ashwadhar naradhara built on the back of the temple and total lack of the grass bar certainly defines it to be of the th century	मंदिर की पीठ पर बना अश्वधर नरधर ग्रास पट्टिका का पूर्णतः अभाव इसे निश्चित रुप से शताब्दी का निश्चित करता है
kumbhashyam is a sandhan type of east facing structure	कुंभश्याम सांधान प्रकार का पूर्वाभिमुखी प्रासाद है
the sanctum sanctorum of the temple is of the trayanga type	मंदिर का गर्भगृह त्रयंग प्रकार का है
every part of the sanctum sanctorum is attached with a salilantar	गर्भगृह का प्रत्येक अंग एक सलिलांतर से जुड़ा है
the statues of digpalas standing in a triangular way on each corner look extremely beautiful	प्रत्येक कर्ण पर दिग्पालों की प्रतिमाएँ त्रिभंग में खड़ी हुई अत्यंत कमनीय दिखाई पड़ती हैं
there are three branches of the chariotlets of bhadra patravalli nagapasha and roopa branch	भद्रा की रथिकाओं की तीन शाखाएँ हैं पत्रवल्ली नागपाश और रुप शाखा
the samadhishwar temple in chittor fort had a place among the important temples	चित्तौड़ दुर्ग में समाधीश्वर मंदिर का स्थान महत्वपूर्ण मंदिरों में था
shiva samadhish had an important place in the life of the people of chittor	शिव समाधीश का चित्तौड़ के जनजीवन में महत्वपूर्ण स्थान था
according to some records samadhishwar temple is known as samidheshwar and in colloquial form as samidhesur as well	कुछ अभिलेखों के अनुसार समाधीश्वर मंदिर को समिधेश्वर तथा अपभ्रंश रुप में ’ समिधेसुर के रूप में भी जाना जाता है
there is disagreement among the historians on the builder installed god construction time and name of the samadhishwar temple	समाधीश्वर मंदिर के निर्माण कर्त्ता अधिष्ठाता देव रचनाकाल तथा नाम को लेकर इतिहासकारों में मतभेद है
according to an edict of a maharaja mokal had renovated the samadhishwar temple	सन् ई की एक प्रशस्ति के अनुसार महाराजा मोकल ने समाधीश्वर मंदिर का जीर्णोद्धार किया था
samadhishwar temple is also known as mokal temple	समाधीश्वर मंदिर को मोकल का मंदिर के रुप में भी जाना जाता है
according to some scholars like shri dhaki samadhishwar temple is the kumar vihara built by chalukya kumarapala	कुछ विद्वानों जैसे श्री ढ़ाकी के अनुसार समाधीश्वर मंदिर चालुक्य कुमारपाल द्वारा निर्मित कुमार विहार है
based on the narathar and kumbhak of vedi bandh and the statues of goddesses and yaksha yakshinis of the jain regime on jangha and based on the edict of a of kumarapala found from the complex of the samadhiswar temple itself it has been considered to be a jain temple	वेदी बंध के नरथर एवं कुंभक तथा जंघा पर जैन शासन देवयों एवं यक्ष यक्षिणियों की मूर्ति के आधार पर तथा समाधीश्वर मंदिर के ही प्रांगण से प्राप्त कुमारपाल की ई की प्रशस्ति के आधार पर इसे जैन मंदिर माना है
in the edict of kumarapala is found the evidence of his being a shiva worshipper only	कुमारपाल की प्रशास्ति में उसके शैव उपासक होने का ही प्रमाण मिलता है
according to the mohaparajay play of yashpal kumarapal had accepted jain religion in a samvat however late	यद्यपि बाद में यशपाल के मोहपराजय नाटक के अनुसार सन् ई संवत् में कुमारपाल ने जैन धर्म स्वीकार कर लिया था
the depiction of scenes available in the samadhishwar temple is generally found from all the jain and hindu temples	समाधीश्वर मंदिर में उपलब्ध दृश्यों का अंकन सामान्य रुप से जैन एवं हिंदू सभी मंदिरों से प्राप्त होता है
the palatial materials and takshak of jain and hindu religions used to be the same	जैन एवं हिंदू धर्मों की प्रासाद वस्तु एवं तक्षक एक ही हुआ करते थे
thus the samadhishwar temple appears to be a shaivite mansion from top to end instead of kumarpala vihara	इस प्रकार समाधीश्वर मंदिर कुमारपाल का विहार का न होकर आद्यंत शैव प्रासाद प्रतीत होता है
the mahesha statue of the shiva of samadhishwar temple that is vamadev is a form of direct bhairav	समाधीश्वर मंदिर शिव की महेश मूर्ति अर्थात वामदेव सद्योजात भैरव का रुप है
the largeness and wonderfulness of the mahesha statue is unique	महेश मूर्ति की विशालता एवं विस्पर्यात्पादकता अपूर्व है
the mahesha statue that is vamadev seems to be of later than th century from the point of view of style	महेश मूर्ति अर्थात वामदेव शैली की दृष्टि से वीं शताब्दी के बाद की प्रतीत होती है
the ground of sanctum sanctorum is lower than the internal canopy	गर्भगृह का धरातल गूढ़ मंडप से नीचा है
it appears that this change has been done during renovation	ऐसा प्रतीत होता है कि जीर्णोद्धार के समय यह परिवर्त्तन किया गया हो
dr ramnath and several other scholars have tried to identify this mansion and its construction period with the tribhuvan narayan temple built by the parmar ruler bhoja	डॉ रामनाथ तथा कई अन्य विद्वानों ने इस प्रासाद की पहचान तथा निर्माण का काल परमार शासक भोज द्वारा निर्मित त्रिभूवन नारायण से करने का प्रयास किया है
according to them this temple was built in a by king bhoja	इनके अनुसार यह मंदिर ई में भोज राजा द्वारा निर्मित किया गया होगा
its description is in the record found in chirawa	इसका उल्लेख चीरवा से प्राप्त अभिलेख में है
kalyanpur is located at a distance of kilometres south of udaipur and has been popular as a shaivapeetha	कल्याणपुर उदयपुर के दक्षिण में किलोमीटर दूर स्थित है तथा शैवपीठ के रुप में लोकप्रिय रहा है
at present the temple is in extreme dilapidation	वर्त्तमान में मंदिर अत्यंत जीर्ण अवस्था में है
according to found records it has been determined to be of th century	प्राप्त अभिलेखों के आधार पर इसे वीं शताब्दी का निश्चित किया गया है
the statues of the temple are made of parewa stone having some greenishness	मंदिर की मूर्तियाँ कुछ हरापन लिए हुए काले परेवा पत्थर की बनी है
the statues of the temple are at present conserved in the pratap museum and m college udaipur	मंदिर की मूर्तियाँ वर्त्तमान में प्रताप संग्रहालय तथा एमबी कॉलेज उदयपुर में संरक्षित हैं
ahar mewar region is an important place from the point of view of sculpture	आहड़ मेवाड़ क्षेत्र का मूर्तिकला की दृष्टि से एक महत्वपूर्ण स्थान है
the ancient names of ahar mewar region is aghatpur atpur and gangodbhed tirtha	आहड़ मेवाड़ क्षेत्र का प्राचीन नाम आघाटपुर आटपुर तथा गंगोद्भेद तीर्थ है
this was a major center of vaishnav sect in the th th century	यह वीं वीं शताब्दी में वैष्णव संप्रदाय का एक प्रमुख केन्द्र था
mention of a vishnu temple is found in a record of a samvat found in ahar	आहड़ से प्राप्त ई संवत् के एक अभिलेख से एक विष्णु के मंदिर का उल्लेख मिलता है
a statue of adi varaha was installed in ahar by a vaishnav devotee	आहड़ में एक वैष्णव भक्त द्वारा आदि वराह की प्रतिमा स्थापित करवाई गई थी
there was a sun temple in ahar	आहड़ में एक सूर्य मंदिर भी था
the proof of the sun temple is found in a record mentioning the contribution of drammas	सूर्य मंदिर का प्रमाण द्रम्मों के दान का उल्लेख करने वाले एक अन्य अभिलेख से मिलता है
in another temple the laxminarayana form of vishnu was worshipped which is now known with the name of mirabai temple	एक अन्य मंदिर में विष्णु के लक्ष्मीनारायण रुप की अर्चना होती थी जिसे अब मीराबाई मंदिर के नाम से जाना जाता है
besides the statues of brahma savitri laxmi narayan sitting on barud uma maheshwar seated on nandi etc in the outer crevices of the temple the scenes of contemporary social life have also been presented	मंदिर के बाह्य ताखों में ब्रम्हासावित्री गरूड़ पर बैठे लक्ष्मीनारायण नंदी पर आसीन उमामाहेश्वर आदि की प्रतिमाओं के अतिरिक्त मेवाड़ के तत्कालीन सामाजिक जीवन के दृश्यों को भी प्रस्तुत किया गया है
unwas is famous for the durga temple	उनवास दुर्गा मंदिर के लिए प्रसिद्ध है
unwas is situated near haldi ghati kilometres away from udaipur	उनवास उदयपुर से किमी दूर हल्दी घाटी के निकट स्थित हैं
the durga temple of unwas is renowned with the name of pippaladmata in the common mass	जन सामान्य में उनवास का दुर्गा मंदिर पिप्पलादमाता के नाम से विख्यात है
the durga temple of unwas built in th century is contemporary of the ambika temple of jagat and this is supposed to be built in the regime of a guhil ruler allat	वीं सदी में निर्मित उनवास का दुर्गा मंदिर जगत का अम्बिका मंदिर का समकालीन है तथा यह एक गुहिल शासक अल्लट के राज्यकाल में निर्मित माना जाता है
the durga temple of unwas is counted in the group of the temples of jhalarapatan and jagat built under the matripuja tradition	उनवास के दुर्गा मंदिर की गणना मातृपूजा परंपरा के अंतर्गत बने झालरापाटन तथा जगत के मंदिर समूहों में की जाती है
in the group of the temples of jhalarapatan and jagat a form of shakti was worshipped uniquely	झालरापाटन तथा जगत के मंदिर समूहों में एकान्तिक रूप से शक्ति के किसी रूप की ही अर्चना की जाती थी
in this the mahishmardini form as peaceful and the grandness of varada form has been presented	इसमें दुर्गा के महिषमर्दिनी स्वरुप को शांत व वरद रूप की दिव्यता को प्रस्तुत किया गया है
compared to sculpture the above mentioned temple of unwas is more important for the study of the development of meaning in architecture	मूर्तिकला की अपेक्षा वास्तुकला के अभिप्रायों के विकास के अध्ययन के लिए उनवास का उपरोक्त मंदिर अधिक महत्वपूर्ण है
there is a lack of decorative meanings of the back of the temple	मंदिर की पीठिका के अलंकरणात्मक अभिप्रायों का इस मंदिर में अभाव है
situated kilometres away from udaipur jagat is known for historical ambika temple	उदयपुर से किलोमीटर दूर स्थित जगत ऐतिहासिक अंबिका मंदिर के लिए जाना जाता है
there are three main parts of this group of temple seminary canopy main temple and a small temple built on the waterway of the main temple	इस मंदिर समूह के तीन प्रमुख अंग हैं सभामंडप मुख्य मंदिर तथा मुख्य मंदिर की जल प्रणालिका पर बना छोटा मंदिर
the use of seminary canopy would have been for musical performances in occasions of the goddess	सभामंडप का उपयोग देवी के उपलक्ष्य में नृत्यगीतादि सभाओं के लिए होता होगा
both the pillars of the entrance are also almost extinct	प्रवेश द्वार के दोनों स्तंभ भी समाप्त प्रायः हैं
a statue of alaskanya standing on the upper part of these pillars was depicted	इन स्तंभों के ऊपरी भाग पर कमल पर खड़ी अलसकन्या की प्रतिमा अंकित थी
the carved meanings of the peethika is still safe	पीठिका के उत्कीर्ण अभिप्राय अभी भी सुरक्षित है
situated kilometres away from udaipur nagda has been the ancient capital of guhil rulers	उदयपुर से किमी दूर स्थित नागदा गुहिल शासकों की प्राचीन राजधानी रह चुकी है
the record of a samvat certifies the anciency of the nagada place	ई संवत् का अभिलेख नागदा स्थान की प्राचीनता को प्रमाणित करता है
at the same time based on the style of archaeological materials nagda does not appear to be so ancient	वहीं पुरातात्विक सामग्री की शैली के आधार पर नागदा उतना प्राचीन प्रतीत नहीं होता
possibly ancient monuments would have dilapidated with time	संभवत प्राचीन स्मारक समय के साथ नष्ट हो गये होंगे
saas temple is big in size	सास मंदिर आकार में बड़ा है
as the guhil rulers were suryavanshi this temple of nagda has been dedicated to vishnu	गुहिल शासकों के सूर्यवंशी होने के कारण नागदा के इस मंदिर को विष्णु को समर्पित किया गया है
a four armed vishnu statue is honourably installed in the main crevice of the back of the sanctum sanctorum	गर्भगृह के पृष्ठभाग की प्रमुख ताख में एक चतुर्भुज विष्णु प्रतिमा प्रतिष्ठित है
on the external parts of both the temples depiction of making up men and women have been done	दोनों मंदिरों के बाह्य भाग पर श्रृंगाररत नरनारियों का अंकन किया गया है
a shakti temple is built on the right side corner of the saas temple in which different forms of shakti have been depicted	सास मंदिर के दाईं ओर के कोने पर एक शक्ति मंदिर निर्मित हैं जिसमें शक्ति के विविध रूपों का अंकन किया गया है
another group of temples near nagda itself is known with the name of eklinga or kailashpuri	नागदा के पास ही एक अन्य मंदिर समूह एकलिंग या कैलाशपुरी के नाम से जाना जाता है
the inscription found from the lakulish temple of nagda is of a and this is the most ancient	नागदा के लकुलीश मंदिर से प्राप्त शिलालेख ई का है और यह सर्वाधिक प्राचीन है
other temples are of th century	अन्य मंदिर वीं शताब्दी के हैं
tus is located on the banks of the berach river near udaipur and the sun temple here has an important place in the study of sculpting tradition	टूस उदयपुर के समीप बेड़च नदी के तट पर स्थित है तथा यहाँ का सूर्य मंदिर मूर्तिकला परंपरा के अध्ययन में विशेष महत्व रखता है
in comparison with the vaishnav sect the sun worship was less popular in the mewar region	वैष्णव संप्रदाय की तुलना में सूर्य पूजा का मेवाड़ क्षेत्र में कम प्रचलन था
a beautiful landmass located between the western side of the arabian sea and the sahyadri mountain ranges is known by the name of kerala	पश्चिमी सीमा पर अरब सागर और सह्याद्रि पर्वत श्रृंखलाओं के मध्य स्थित एक खूबसूरत भूभाग को केरल के नाम से जाना जाता है
the area of the state of kerala is square kilometres	केरल राज्य का क्षेत्रफल वर्ग किलोमीटर है
malayalam language is spoken in kerala	केरल में मलयालम भाषा बोली जाती है
recognized due to its culture and language specialties kerala has an important place among the four states situated in the south of india	अपनी संस्कृति और भाषा वैशिष्ट्य के कारण पहचाने जाने वाले भारत के दक्षिण में स्थित चार राज्यों में केरल प्रमुख स्थान रखता है
major neighboring states of kerala are tamil nadu and karnataka	केरल के प्रमुख पड़ोसी राज्य तमिलनाडु और कर्नाटक हैं
the landmass known by the name of mayyazhi mahe of the state of pondicherry puducchery is also under the kerala state	पोंडिच्चेरी पुतुच्चेरी राज्य का मय्यष़ि माहि नाम से जाना जाने वाला भूभाग भी केरल राज्य के अन्तर्गत स्थित है
the national territory of lakshadweep situated in the arabian sea also has an unbreakable relation with kerala in view of the language and culture	अरब सागर में स्थित केन्द्र शासित प्रदेश लक्षद्वीप का भी भाषा और संस्कृति की दृष्टि से केरल के साथ अटूट संबंध है
before the achievement of independence there were estates of kings in kerala	स्वतंत्रता प्राप्ति से पूर्व केरल में राजाओं की रियासतें थीं
in july the state of tirukochi was constituted by joining the estates of tiruvitankur and cochin	जुलाई में तिरुवितांकूर और कोच्चिन रियासतों को जोडकर तिरुकोच्चि राज्य का गठन किया गया
at that time the region of malbar was only a district of the madras state present tamilnadu	उस समय मलबार प्रदेश मद्रास राज्य वर्तमान तमिलनाडु का एक जिला मात्र था
in november malbar was also joined with tirukochi and thus the present kerala was established	नवंबर में तिरुकोच्चि के साथ मलबार को भी जोड़ा गया और इस तरह वर्तमान केरल की स्थापना हुई
thus by constituting aikya keralam the long time desire of the people of this part of land was fulfilled	इस प्रकार ऐक्य केरलम के गठन के द्वारा इस भूभाग की जनता की दीर्घकालीन अभिलाषा पूर्ण हुई
kerala can be proud of its ancient history long time foreign trade relation and the rich tradition of science and arts	केरल अपने प्राचीन इतिहास दीर्घकालीन वैदेशिक व्यापारिक संबंध और विज्ञान एवं कला की समृद्ध परंपरा पर गर्व कर सकता है
in view of literacy kerala has an important place in the whole country	साक्षरता की दृष्टि से केरल का पूरे देश में महत्वपूर्ण स्थान है
kerala has an important place in the areas of social justice health level men women equality and obedience of law education etcetera	सामाजिक न्याय स्वास्थ्य स्तर स्त्री पुरुष समानता और कानून के पालन शिक्षा आदि क्षेत्रों में केरल का प्रमुख स्थान है
the most important thing is that infant mortality rate is the lowest in kerala	सबसे महत्वपूर्ण बात यह है कि शिशुमृत्युदर केरल में सबसे कम है
due to more rains the water mass of the kerala region is rich and the land here is always covered with greenery	अधिक वर्षा के कारण केरल प्रदेश की जलराशि समृद्ध है और यहाँ की भूमि सदैव हरियाली से युक्त रहती है
due to excellent weather the good facility of transport and the rich cultural tradition the state of kerala is famous among tourists	उत्कृष्ट जलवायु यातायात की अच्छी सुविधाओं और समृद्ध सांस्कृतिक परंपराओं के कारण केरल राज्य पर्यटकों में लोकप्रिय है
not only this other specialties of kerala are wakened political awareness the impact of media the capacity to absorb other cultures etc	यही नहीं केरल की अन्य विशेषताएँ हैं प्रबुद्ध राजनैतिक चेतना संचार माध्यमों का प्रभाव अन्य संस्कृतियों को आत्मसात करने की क्षमता आदि
famous for mutual religious respect kerala is the confluence land of different cultures	धार्मिक सौहार्द के लिए प्रसिद्ध केरल विभिन्न संस्कृतियों की संगम भूमि है
there is no unanimous opinion among scholars on the issue of the derivation of the word kerala	केरल शब्द की व्युत्पत्ति को लेकर विद्वानों में एकमत नहीं है
it is said that the word kerala has been formed with the combination of the words chersthal keechad and alampradesh	कहा जाता है कि चेरस्थल कीचड़ और अलमप्रदेश शब्दों के योग से केरल शब्द बना है
there is another meaning of kerala the land that came out of the sea	केरल शब्द का एक और अर्थ है वह भूभाग जो समुद्र से निकला हो
the confluence place of the sea and the mountain is also called kerala	समुद्र और पर्वत के संगम स्थान को भी केरल कहा जाता है
ancient foreign wanderers have addressed this place with the name of malbaar as well	प्राचीन विदेशी यायावरों ने इस स्थल को मलबार नाम से भी सम्बोधित किया है
the culture of kerala is thousands of years old	केरल की संस्कृति हज़ारों साल पुरानी है
in the beginning people used to live in hilly areas	प्रारंभ में लोग पहाड़ी इलाकों में रहते थे
some ruins of the ancient stone age have been found from some parts of kerala	केरल के कुछ भागों से प्राचीन प्रस्तर युग के कतिपय खण्डहर प्राप्त हुए हैं
besides the ancient ruins the megalithic commemorative volumes also give authentic information about the human life in kerala	प्राचीन खण्डहरों के अतिरिक्त महाप्रस्तर स्मारिकाएँ भी केरल में मानव जीवन की प्रामाणिक जानकारियाँ देती हैं
these megalithic memorabilias are found mostly in the form of crematorium	ये अधिकतर श्मशान रूप में प्राप्त होती हैं
many crematoriums of the ancient stone age have been found here	यहाँ पर प्राचीन महाप्रस्तर काल के अनेक श्मशानस्थल खोजे गये हैं
these are known with the names as kudakkallu umbrellashaped cliffs toppikkallu capshaped stones kalmesha table made of stone muniyara shed of saints nannangadi pit of ashes etc	जिन्हें कुडक्कल्लु छत्राकार शिलाएँ तोप्पिक्कल्लु टोपी नुमा शिलाएँ कल्मेशा पत्थर से बनी मेज़ मुनियरा मुनियों की कोठरी नन्नङाडि भस्मकुंभ आदि नामों से जाना जाता है
their period is supposed to be from b to	इनका काल ईं पूर्व से तक माना जाता है
most of commemorative volumes of the megalithic age have been found from the hilly areas	अधिकतर महाप्रस्तर युगीन स्मारिकाएँ पहाड़ी क्षेत्रों से प्राप्त हुई
so it is proved that the residence of the humans was in kerala from the most ancient times	अतः यह सिद्ध होता है कि केरल में अतिप्राचीन काल से मानव का वास था
the second stage of the development of the living centers in kerala is supposed to be the sangam age	केरल में आवास केन्द्रों के विकास का दूसरा चरण संघमकाल माना जाता है
this is the very age of the formation of ancient tamil literature	यही प्राचीन तमिल साहित्य के निर्माण का काल है
sangam age continued from a to a	संगमकाल सन् ई से ई तक रहा
it is in this period that people coming from other provinces started settling down in kerala and the propagation of buddhism and jainism occurred	इसी काल में भारत के अन्य प्रान्तों से भी आकर लोग केरल में बसने लगे तथा बौद्ध और जैन धर्मों का प्रचार हुआ
the brahmin arrival also happened in this very period	ब्राह्मण आगमन भी इसी काल में हुआ
there were overall settlements of the brahmins in different areas of kerala in those days	उन दिनों केरल के विभिन्न क्षेत्रों में ब्राह्मणों की कुल मिलाकर बस्तियाँ थीं
the christian religion had reached kerala by the first century of jesus	ईसा की पहली शताब्दी तक केरल में ईसाई धर्म भी पहुँच गया था
in ad christian faithful of the seven tribes of western asia under the leadership of thomas of kanaye came and settled in kerala	सन् में कानायि के थॉमस के नेतृत्व में पश्चिम एशिया के सात कबीलों के ईसाई धर्मावलम्बी केरल आकर बसे
christian religion propaganda got strength in kerala with the seven tribes of the western asia	पश्चिम एशिया के सात कबीलों से केरल में ईसाई धर्म प्रचार को बल मिला
the citizen of kerala got acquainted with the islam religion since eighth century itself	आठवीं ईस्वीं से ही केरलवासी इस्लाम धर्म से परिचित हो गए
the historians considered the ancient kerala as a part of the tamil region	प्राचीन केरल को इतिहासकार तमिल भूभाग का अंग समझते थे
the main elements which helped in the independent development of kerala are the citizen s love for nature the development of residential centers rise of industrial center and language enrichment	केरल के स्वतंत्र विकास में जो तत्व सहायक हुए हैं उनमें मुख्य हैं निवासियों का प्रकृति प्रेम आवास केन्द्रों का विकास उत्पादन केन्द्रों का उदय और भाषाई समृद्धि
a lot of social changes occurred in kerala when the control of agriculture and resources came in the hands of landlords	जब कृषि और संसाधन का नियंत्रण ज़मींदारों के हाथों में आ गया तब केरल में अनेक सामाजिक परिवर्तन हुए
as a result development from small estates to large states took place	परिणामस्वरूप छोटी रियासतों से लेकर बड़े राज्यों का विकास हुआ
thus the history of kerala is the history of empires and wars	इस तरह केरल का इतिहास साम्राज्यों और युद्धों का इतिहास है
it is a history of language and literature	भाषा और साहित्य के विकास का इतिहास है
it is the history of the arrival of foreign armies and becoming their long term colony it is the history of the casteism and exploitation	विदेशी सेनाओं के आगमन तथा उनके दीर्घकालीन उपनिवेश बन जाने का इतिहास है जातिपाँति और शोषण का इतिहास है
it is the history of the progress occurring in education and promotion taking place in the scientific areas	शिक्षा में हुई प्रगति और वैज्ञानिक क्षेत्रों में हुई तरक्की का इतिहास है
it is the history of commercial progress and social renaissance and the emergence of democratic institutions	व्यापारिक प्रगति और सामाजिक नवजागरण और जनतांत्रिक संस्थाओं के आविर्भावों का इतिहास है
for the sake of convenience the history of kerala can be divided into three parts ancient middle age and modern age	सुविधा की दृष्टि से केरल के इतिहास को प्राचीन मध्यकालीन एवं आधुनिक कालीन तीन भागों में विभाजित कर सकते हैं
kerala is rich with rare vegetation and animals and bushes	केरल दुर्लभ वनस्पतियों और पशुओं से युक्त झाड़ियों से युक्त स्थान है
though there are large trees also here but chinnar is appropriate for all the bushes here	यद्यपि यहाँ बडे़बड़े वृक्ष भी हैं चिन्नार फिर भी यहाँ की सभी झाड़ियों के लिए उपयुक्त है
rare brown colored squirrels which are on the verge of extinction is found here	यहाँ भूरे रंग की लुप्त प्राय होती जा रही दुर्लभ गिलहरियाँ भी मिलती हैं
the number of these squirrels giant grizzled squirrel of india in the world is about	विश्व में इन गिलहरियों की संख्या लगभग है
here rain ensues very less in comparison with other wild areas of kerala	केरल के अन्य वनक्षेत्र की अपेक्षा यहाँ बहुत कम वर्षा होती है
rain ensues here only days on an average in a year	यहाँ वर्ष में औसतन दिन ही वर्षा होती है
a place named chandanakkadu near chinnar is appropriate for wildlife view	चिन्नार के समीपस्थ चन्दनक्काडु नामक स्थान वन्यजीव दर्शन के लिए उपयुक्त है
wild oxen can be seen in this dense forest	इस घने जंगल में गौरों को देखा जा सकता है
elephant leopard hanumanmonkey peacock etc are seen on both sides of the road	हाथी चीतल हनुमानबंदर मोर आदि मार्ग के दोनों ओर दिखाई देते हैं
the nearest railway station ernakulam k	निकटतम रेलवे स्टेशन एरणाकुलम किमी
the nearest airport kochhi international airport k	निकटतम एयरपोर्ट कोच्चि अन्तर्राष्ट्रीय हवाई अड्डा किमी
this place is filled with fields of large grass and shady trees	यह स्थान बड़े बड़े घास के चौगानों और छायादार वृक्षों से युक्त है
spread in about square kilometres this national park is very charming	करीब वर्ग किमी क्षेत्रफल में फैला यह राष्ट्रीय उद्यान अति मनोहर है
this is the natural living place of the nilgiri cow	यह नीलगीरि गाय का नैसर्गिक निवास स्थान है
the nilgiri cow is becoming extinct now	अब नीलगीरि गाय लुप्त प्राय होती जा रही है
here animals like nilgiri long tailed monkey short tailed monkey leopard tiger etc are also found	यहाँ नीलगिरि लंगूर लघु पुच्छ वानर चीता व्याघ्र आदि जानवर भी मिलते हैं
this region is specially conserved so tourists can only enter the tourist area	यह क्षेत्र विशेष संरक्षित है अत पर्यटक केवल पर्यटकक्षेत्र में ही प्रवेश कर सकते हैं
there is no permission to go there during the time of monsoon	मानसून के समय वहाँ जाने की अनुमति नहीं है
gavi is internationally acclaimed ecotourism center	गावि अन्तर्राष्ट्रीय स्तर पर प्रसिद्धी प्राप्त करने वाला इकोटूरिज्म केन्द्र है
gavi is under the kerala forest development centre	गावि केरल वन विकास केन्द्र के अधीन है
the world tourism organization called alistair international has emphasized on the necessity of tourism by the tourists in this area	एलिस्टेयर इन्टरनेशनल नामक विश्व पर्यटन संस्था ने पर्यटकों को इस क्षेत्र में पर्यटन करने की आवश्यकता पर बल दिया
gavi is an appropriate place for wild animal observation tracking etc	गावि वन्यपशु निरीक्षण ट्रेकिंग आदि के लिए उपयुक्त स्थान है
local people work cheap for all the works starting from erecting the tent in the forest to providing ready food in gavi	गावि में वन में तम्बू लगाने से लेकर भोजन तैयार करके देने का काम स्थानीय लोग सस्ते दामों पर करते हैं
the travel of gavi starts from the middle of the tea gardens	गावि की यात्रा चाय के बागानों के बीच से शुरु होती है
crossing the places like mundakkayam kuttikkanam peerumedu etc we go to gavi through vandiperiyar	मुण्डक्कयम कुट्टिक्कानम पीरुमेडु आदि स्थानों को पार करते हुए वण्डिप्पेरियार से गावि को जाया जाता है
one can stay in the ecolodge named green manson after reaching gavi	गावि पहुँचने पर ग्रीन मैनशन नामक इको लॉज में ठहरा जा सकता है
if you want to stay in tents after establishing it near a tree or houses made on trees it is also possible	यदि आप पेड़ों के पास तम्बू लगाकर या फिर पेड़ पर बने घरों में रहना चाहें तो यह भी संभव हैं
gavi lake is near ecolodge	इको लॉज के पास गावि सरोवर है
there is boating facility here	यहाँ बोटिंग की सुविधा है
forest field of grass hills valleys garden of cardamom plants etc are seen around the lake	सरोवर के चारो तरफ वन घास के मैदान पहाडियाँ घाटियाँ इलायची के बागान पेड़पौधे आदि दिखाई देते हैं
animals like the nilgiri cow short tailed monkeys etc can be seen at a very close distance	नीलगिरि गाय लघु पुच्छ वानर आदि पशुओं को बहुत ही निकट से देखा जा सकता है
overall species of birds live here including malmusshkki the bird whose sound echoes in the hills the pied cuckoo woodpecker the blue jay etc	यहाँ मलमुष़क्कि वह चिड़िया जिसकी आवाज़ पहाड़ी में गूँजती है चातक कठफोडवा नील कंठ आदि कुल मिलाकर पक्षियों की प्रजातियाँ रहती हैं
coming out of gavi we can go ahead	गावि से निकल कर आगे जाया जा सकता है
animals coming out in the night can also be seen by traveling kollur gavi grass gardens kochhu pampa pachhakkanam etc	कोल्लूर गावि घास के बगीचों कोच्चु पम्पा पच्चक्कानम आदि स्थानों की यात्रा करके रात में निकलने वाले जीव जन्तुओं को भी देखा जा सकता है
living in gavi tree house and tents etc one also gets the opportunity to savor the wildlife	गावि ट्री हाउस और तम्बू आदि में रहते हुए वन जीवन के रसास्वादन का अवसर भी मिलता है
gavi is k from vandiperiyar and k from tekkadi	गावि वण्डिप्पेरियार से किमी और तेक्कडि से किमी है
echo point is very appropriate place for adventure tourism and tracking	इक्को प्वाइंट साहसी पर्यटन एवं ट्रेकिंग के लिए बहुत ही उपयुक्त स्थान है
echo point falls on the way from munnar to top station	मुन्नार से टोप स्टेशन को जाने के रास्ते में इक्को प्वाइंट पड़ता है
the area of echo point is surrounded with hills like mankunnu kodiyatturmala tonippara etc and is appropriate for tracking	इक्को प्वाइंट का क्षेत्र मांकुन्नु कोडियत्तूरमला तोणिप्पारा आदि पहाड़ियों से घिरा हुआ है तथा ट्रेकिंग के लिए उपयुक्त है
ilvishapunchira is near kanjar	इलवीष़ापुंचिरा कांजार के निकट है
going to kanjara from palaya of kottayam district is easy	कोट्टयम जिला के पालाय से कांजार जाना आसान है
a fascinating waterfall forms with the water falling from a height of metres along with a fierce roar in kanjar	कांजार में मीटर की ऊँचाई से घोर गर्जना के साथ गिरते जल से एक मनोहारी जलप्रपात बनता है
kanjar waterfall remains filled with water whole year	कांजार जलप्रपात पूरे वर्ष जलयुक्त रहता है
kanjar is appropriate for tracking	कांजार ट्रेकिंग के लिए उपयुक्त है
enough amount of herbs are found in kanjar	कांजार में पर्याप्त मात्रा में जड़ीबूटियाँ प्राप्त होती हैं
attukal presents a fascinating scene with waterfall curvy hills	जलप्रपात ऊँचीनींची पहाड़ियों से युक्त आट्टुकल मनोरम दृश्य उपस्थित करता है
if you want to visit the whole of goa in the shortest time and with the least money then take the services of the tourist buses	अगर पूरा गोवा कम से कम समय और पैसे में घूमना चाहते हैं तो वहाँ टूर करवाने वाली बसों की सेवा लें
kanjar is in between munnar and pallivasal	कांजार मुन्नार और पल्लिवासल के बीच में है
the natural place for sandal trees in kerala is marayur	केरल में चन्दन वृक्षों का नैसर्गिक स्थान है मरायूर
the visiting places of marayur are the sandal factory of the forest department the caves decorated with the stone age images the shady banyan tree expanding over one hectare etc	मरायूर के दर्शनीय स्थान हैं वन विभाग का चन्दन फैक्टरी प्रस्तर युगीन चित्रों से सज्जित गुफाएँ एक हेक्टेयर ज़मीन पर फैला हुआ छायादार बरगद का पेड़ आदि
tuvanam waterfall rajeev gandhi national park etc are situated near marayur	तूवानम जलप्रपात राजीव गांधी राष्ट्रीय उद्यान आदि मरायूर के निकट हैं
the archaeological supremacy of marayur is also no less than others	मरायूर का पुरातात्त्विक प्राधान्य भी कम नहीं
stone age caves and several ancient graves have been excavated here	यहाँ प्रस्तरयुगीन गुफाएँ और अनेक प्रचीन कब्रें खोद कर निकाली गई है
indoswiss dairy farm is one of the visiting places in mattuppetti	माट्टुप्पेट्टि के दर्शनीय स्थानों में एक इन्डोस्विस डेयरी फार्म है
the indoswiss dairy farm of mattuppetti has been built metres above the sea level	माट्टुप्पेट्टि का इन्डोस्विस डेयरी फार्म समुद्र तल से मीटर की ऊँचाई पर बनाया गया है
there are modern cowsheds in indoswiss dairy farm	इन्डोस्विस डेयरी फार्म में आधुनिक गोशालाएँ हैं
from these modern cowsheds only three cowsheds have been opened for tourists	इन आधुनिक गोशालाओं में से केवल तीन ’ गोशालाएँ ’ पर्यटकों के लिए खोली गई हैं
other sights here are mattupetti dam lake the kundala tea garden kundala lake etcetera	यहाँ के दूसरे दृश्य हैं माट्टुप्पेट्टि बाँध सरोवर कुण्डला चाय बागान कुण्डला सरोवर आदि
d has managed the boat travel in this lake	डीटीपीसी ने इस सरोवर में बोट यात्रा की व्यवस्था की है
the center of pallivasal water electricity plan of is situated near mattupetti	पल्लिवासल जल विद्युत योजना का केन्द्र चित्रपुरम माट्टुप्पेट्टि के समीप है
munnar is one of the popular hill stations of india	भारत के प्रसिद्ध हिल स्टेशनों में एक है मुन्नार
the natural splendor of munnar drenching the heart and soul with pleasure is indescribable	तन मन को आनंद से सराबोर करने वाली मुन्नार की प्राकृतिक सुषमा अनिर्वचनीय है
due to being located at confluence of the rivers of mudrappuzha nallatanni kundala etc unique greenery is seen in munnar	मुद्रप्पुष़ा नल्लतण्णि कुण्डला आदि नदियों के संगम स्थान पर स्थित पहाड़ियों के कारण मुन्नार में अनुपम हरितिमा के दर्शन होते हैं
munnar is a hilly area situated at a height of metres above the sea level	मुन्नार समुद्रतल से मीटर की ऊँचाई पर स्थित पहाड़ी इलाका है
munnar was one of the important summer residences of india	मुन्नार भारत के महत्वपूर्ण ग्रीष्म आवासों में एक था
the british used to reside in munnar during the british regime	मुन्नार में ब्रिटिश शासन काल में गोरे रहा करते थे
it was the owners of the british gardens who got the tea garden planted in munnar	ब्रिटिश बागान मालिकों ने ही मुन्नार में चाय बागान लगवाए थे
it is the specialty of munnar is that here tourists never get bored	मुन्नार की खूबी यह है कि यहाँ पर्यटक कभी भी नहीं ऊबते हैं
it is good to travel through the middle of the tea garden at a distance of k from munnar town	मुन्नार टाउन से किमी दूरी पर चाय के बागानों के बीच से यात्रा करना अच्छा है
there is a dense forest around the dam	बाँध के चारों ओर घना जंगल है
top station is the highest area k away from munnar on munnar kodaikanal road	टोप स्टेशन मुन्नार से किमी दूर मुन्नार कोडाइकनाल मार्ग पर सबसे ऊँचा क्षेत्र है
it is here that the world famous flower called neelkurinji blooms	यहीं नीलकुरिंजि नामक विश्व प्रसिद्व फूल खिलते हैं
one can also get to see the glimpse of tamilnadu from the top of these hills	इन पहाड़ियों पर से तमिलनाडु की झाँकी भी देखने को मिलती है
neelkurinji blooms once in twelve years	नीलकुरिंजि बारह साल में एक बार खिलता है
this is boon of nature for kerala	यह केरल के लिए प्रकृति का वरदान है
when neelkurinji blooms it seems as if the hills are drowned in blue color	जब नीलकुरिंजि खिलते हैं तो पहाडियाँ ऐसी लगती हैं मानो नीले रंग में डूबी हो
these flowers are found in about shades of blue color	ये फूल नीले रंग के करीब शेड्स में मिलते हैं
when it blooms it appears as if whole nature has bathed in blue color	जब ये खिलते हैं तो प्रतीत होता है कि मानों संपूर्ण प्रकृति नीले रंग से नहा उठी है
this mesmerising view of nature enchants the tourists in the areas of koviloor kadavari rajmala iravikullam munnar	प्रकृति का यह अद्भुत नज़ारा कोविलूर कडावरि राजमला इराविकुळम मुन्नार क्षेत्रों में दर्शकों को मंत्रमुग्ध करता है
last time neelkurinji bloomed in	पिछली बार नीलकुरिंजि में खिला था
although neelkurinji blooms every year on some hills but for total blue flower festival we will have to wait till	हालाँकि हर वर्ष कुछ पहाड़ियों पर नीलकुरिंजि खिलते हैं किन्तु पूर्ण नीलाम पुष्पोत्सव के लिए हमें तक प्रतीक्षा करनी पड़ेगी
tea museum should also be given place in munnar tourism program	मुन्नार पर्यटन कार्यक्रम में चायसंग्रहालय को भी स्थान देना चाहिए
tea museum is in the tea estate known as nalltanni which is under the ownership of tata tea	चाय संग्रहालय नल्लतण्णि नामक टी इस्टेट में है जो टाटा टी के स्वामित्व में है
important among the ancient items displayed in the tea museum of munnar are the chain of development of tea farming in munnar ancient instruments which were used for transforming the dense forests into tea garden	मुन्नार के चाय संग्रहालय में प्रदर्शित प्राचीन वस्तुओं में महत्त्वपूर्ण हैं मुन्नार में चाय की खेती के विकास की कड़ियाँ आदिकालीन यंत्र जो घने जंगलों को चाय के बागान में बदलने के लिए प्रयुक्त किए जाते थे
tea roller of peltan wheel of parts of the trains running on the light rail track founded in high range for carrying the tea etcetera	का टी रोलर का पेल्टन व्हील चाय ले जाने के लिए हाई रेंज में स्थापित लाइट रेल पटरियों पर चलने वाली रेलगाड़ियों के कलपुर्जे आदि
the exhibition of different levels of the production of tea leaf is very attractive	चाय पत्ती के निर्माण की विविध स्तरों का प्रदर्शन बहुत ही आकर्षक है
another important thing is a funeralashespot of second century before christ which you can see	एक दूसरी प्रमुख वस्तु है ईसा पूर्व दूसरी शताब्दी का एक चिताभस्मकलश जो आप देख सकते हैं
besides this the traditional systems of tea production tea leaves of different types have also been displayed here	इसके अतिरिक्त चायउत्पादन की परंपरागतप्रणालियाँ विभिन्न प्रकार की चायपत्तियाँ भी यहाँ प्रदर्शित की गई हैं
pandikkushi area of idukki district is appropriate for the photography of forests and wild life	इडुक्कि जिले का पाण्डिक्कुष़ि क्षेत्र वन तथा वन्यजीव फोटोग्राफ़ी के लिए उपयुक्त है
the abundant nature of pandikkushi and diverse wild life enchant visitors	पाण्डिक्कुष़ि की शस्य श्यामल प्रकृति एवं विविध वन्यजीव दर्शकों को मंत्रमुग्ध कर देते हैं
pandikkushi is situated on the border of tamilnadu near chellarkovil	पाण्डिक्कुष़ि चेल्लारकोविल के पास तमिलनाडु की सीमा पर स्थित है
peerumedu is a hill station situated an a height of metres above the sea level	पीरुमेडु समुद्रतल से मीटर की ऊँचाई पर स्थित हिल स्टेशन है
gardens of tea coffee rubber cardamom eucalyptus etcetera keep the greenery of peerumedu alive	पीरुमेडु की हरितिमा को चाय कॉफी रबड़ इलायची युकेलिप्टस आदि के बागान जीवित रखते हैं
the field of grass waterfall pine tree etcetera increase the beauty of peerumedu fourfold	घास के मैदान जलप्रपात चीड़ वृक्ष आदि पीरूमेडू की खूबसूरती में चार चाँद लगा देते हैं
peerumedu is a suitable place for tracking cycling horse riding etcetera	पीरुमेडु ट्रेकिंग साईकिल सवारी घुड़ सवारी आदि के लिए उपयुक्त स्थान है
pulmedu is an evergreen mountain range near the periyar river	पेरियार नदी से सटी शस्य श्यामल पर्वतमाला है पुलमेडु
shabarimala temple is visible from peerumedu	पीरुमेडु से शबरीमला मंदिर दिखाई देता है
pulmedu falls on the way to shabarimala temple	शबरीमला मंदिर जाने के एक मार्ग में पुलमेडु पड़ता है
we can reach pulmedu by jeep only	हम जीप से ही पुलमेडु पहुँच सकते हैं
as it is a preserved forest area it is necessary to take permission from the forest department for visit	संरक्षित वनक्षेत्र होने के कारण भ्रमण के लिए वन विभाग की अनुमति आवश्यक है
chellarkovil is a part of peerumedu itself there are several waterfalls here	चेल्लारकोविल पीरुमेडु का ही एक भाग है यहाँ अनेक जलप्रपात हैं
chellarkovil area is rich with extremely charming nature	चेल्लारकोविल क्षेत्र अत्यन्त रमणीय प्रकृति से युक्त है
standing rock is a part of chellarkovil village	चेल्लारकोविल ग्राम का एक हिस्सा खड़ी चट्टान है
coming down the standing rock of chellarkovil village is standing up to the coconut gardens situated in kambam of tamilnadu	चेल्लारकोविल ग्राम की खड़ी चट्टान नीचे चलकर तमिलनाडु के कम्बम में स्थित नारियल के बगानों तक खड़ी है
vandiperiyar is a nature enriched region	वण्डिप्पेरियार प्रकृति समृद्ध प्रदेश है
tea coffee black pepper etcetera are cultivated in vandiperiyar	वण्डिप्पेरियार में चाय कॉफी कालीमिर्च आदि की खेती होती है
periyar river flows through the midst of it	इस के बीचोंबीच से पेरियार नदी बहती है
there is a government agriculture park and a flower garden here	यहाँ सरकारी कृषिउद्यान एवं पुष्पोद्यान है
this hill is the center of fruits flowers vegetables etcetera	यह पहाड़ी फलफूल कन्दमूल आदि का केन्द्र है
the meaning of the name pattumala is the mountain filled with greenery which appears as if covered with green silk	पट्टुमला नाम का तात्पर्य है कि हरियाली युक्त पहाड़ी जो ऐसी लगे कि मानो हरे रेशम से ढकी हो
the beauty of pattumala situated in peerumedu is transcendental	पीरुमेडु में स्थित पट्टुमला का सौन्दर्य अलौकिक है
pattumala in its beauty is charming the world	पट्टुमला अपने सौन्दर्य में विश्व को लुभा रहा है
situated on top of the green mountain of pattumala velankanni mata church is a famous pilgrimage	पट्टुमला की हरीभरी पहाड़ी की चोटी पर स्थित वेलांकण्णिमाताचर्च एक प्रसिद्ध तीर्थस्थान है
there is a beautiful park also just near the church	चर्च के एकदम निकट एक सुन्दर उद्यान भी है
vandanmedu is world famous cardamom sale center	वण्डनमेडु विश्व प्रसिद्ध इलायची बिक्रय केन्द्र है
there is a crowd of traders of the world over in the auction center of vandanmedu	वण्डनमेडु के नीलाम केन्द्र में विश्व भर के व्यापारियों की भीड़ रहती है
idukki is a forest region with dense jungles and fields of grass	इडुक्कि घने जंगलों तथा घास के चौगानों से युक्त वन प्रदेश है
tattekkad comes under the devikulam tehsil of idukki district	तट्टेक्काडु इडुक्कि जिले के देविकुलम तहसील के अन्तर्गत आता है
about rare species of birds are found in taddekkad idukki	तट्टेक्काडु इडुक्कि में लगभग प्रजातियों के दुर्लभ पक्षी मिलते हैं
therefore the government of kerala has established a bird sanctuary in this area after the name of acclaimed ornithologist dr saleem ali	अतः केरल सरकार ने इस क्षेत्र में प्रसिद्ध पक्षी निरीक्षक डॉ सलीम अली के नाम से पक्षी अभ्यारण्य बनाया है
the bird sanctuary of tettekkad idukki is world famous	तट्टेक्काडु इडुक्कि पक्षी अभ्यारण्य विश्व प्रसिद्घ है
tattekkad idukki is k away from kochi city	तट्टेक्काडु इडुक्कि कोच्चि नगर से किमी दूर है
situated between the two streams of the periyar river tattakkad is an island with an area of square k	तट्टेक्काडु पेरियार नदी की दो धाराओं के बीच में स्थित वर्ग किमी क्षेत्रफल वाला द्वीप है
besides several species of birds animals of types large trees nine types of reptiles etcetera are found in tattekadu	तट्टेक्काडु में पक्षियों की अनेक प्रजातियों के अतिरिक्त प्रकार पशु भीमाकार वृक्ष नौ प्रकार के सरीसृप आदि पाए जाते हैं
idukki wildlife sanctuary is situated at a height of metres above the sea level	इडुक्कि वन्यजीव अभ्यारण्य समुद्र तल से मीटर ऊँचाई पर स्थित है
idukki wildlife sanctuary is spread in an area of square k ms	इडुक्कि वन्यजीव अभ्यारण्य वर्ग किमी क्षेत्र में व्याप्त है
idukki wildlife sanctuary comes under the thodupuzha and udumpanchola tehsils	इडुक्कि वन्यजीव अभ्यारण्य तोडुपुष़ा और उडुम्बनचोला तहसीलों के अन्तर्गत आता है
idukki wildlife sanctuary is a forest area in the middle of periyar and cherutonipuzha	इडुक्कि वन्यजीव अभ्यारण्य पेरियार और चेरुतोणिप्पुष़ा के मध्य का वनप्रदेश है
periyar and chrutonipuzha forest area are evergreen woods in this area	पेरियार और चेरुतोणिप्पुष़ा वनप्रदेश इस क्षेत्र में सदाबहार वन हैं
animals like wild boar tiger etcetera live in periyar and cherutonipuzha	पेरियार और चेरुतोणिप्पुष़ा में जंगली सुअर व्याघ्र आदि पशु रहते हैं
cobra viper shining serpent mainah nightingale woodpecker sparrow etc are also found in this forest	नाग वाइपर दुबोइया चमकीला साँप मैना बुलबुल कठफोड़वा रामचिरैया आदि भी इस वन में पाये जाते हैं
idukki wildlife sanctuary is near the idukki dam	इडुक्कि वन्यजीव अभ्यारण्य इडुक्कि बाँध के निकट है
there is also a facility of boat travel from periyar	पेरियार से बोट यात्रा की भी व्यवस्था है
vandiperiyar is nature enriched region	वण्डिप्पेरियार प्रकृति समृद्ध प्रदेश है
farming of tea coffee black chilly etc are done in vandiperiyar	वण्डिप्पेरियार में चाय कॉफी कालीमिर्च आदि की खेती होती है
periyar river flows from the middle of vandiperiyar	वण्डिप्पेरियार के बीचोंबीच से पेरियार नदी बहती है
government agriculture parks and flower gardens are there in vandiperiyar	वण्डिप्पेरियार में सरकारी कृषिउद्यान एवं पुष्पोद्यान है
vandiperiyar hill is the center of fruitsflowers vegetables etc	वण्डिप्पेरियार पहाड़ी फलफूल कन्दमूल आदि का केन्द्र है
ramakkalmedu is tourist center with calm beautiful atmosphere and slow wind	प्रशांत सुन्दर वातावरण और मन्दमन्द हवा से युक्त भ्रमण केन्द्र है रामक्कल्मेडु
views of kambam bodi etcetera are seen at a distance from the hill	पहाड़ी पर से कम्बम बोडी इत्यादि दूर के दृश्य दिखलाई देते हैं
ramakkalmedu is situated k from idukki and k away from munnar	रामक्कल्मेडु इडुक्कि से किमी तथा मुन्नार से किमी दूर स्थित है
the buses go for ramakkalmedu in the morning at oclock from munnar oclock from kottayam and oclock from ernakulam	प्रातः बजे मुन्नार से बजे कोट्टयम से और बजे एर्णाकुलम से रामक्कल्मेडु के लिए बसें जाती हैं
the famous ayurveda center named sahyadri is in pallikkunnu	पल्लिक्कुन्नु में सह्याद्रि नामक प्रसिद्ध आयुर्वेद केन्द्र है
sahyadri ayurveda centre is under the peerumedu development committee	सह्याद्रि आयुर्वेद केन्द्र पीरुमेडु विकास समिति के अधीन है
there is a park of herbal vegetation near sahyadri ayurveda center where in essential medical herbs have been grown for medicine	सह्याद्रि आयुर्वेद केन्द्र के पास औषधीय वनस्पतियों का एक उद्यान है जिसमें चिकित्सा के लिए आवश्यक जड़ीबूटियाँ उगाई गई हैं
besides the treatment of different diseases in sahyadri herbal center welfare treatment i health improvement treatment has also been arranged	सह्याद्रि आयुर्वेद केन्द्र में विभिन्न रोगों की चिकित्सा के अतिरिक्त सुख चिकित्सा अर्थात् स्वास्थ्य वर्धन चिकित्सा की भी व्यवस्था की गई है
kerala can be proud of periyar wildlife sanctuary	केरल पेरियार वन्यजीव अभ्यारण्य पर गर्व कर सकता है
periyar wildlife sanctuary is situated on the shore of periyar lake	पेरियार वन्यजीव अभ्यारण्य पेरियार सरोवर के तट पर बसा है
this region of periyar wildlife sanctuary situated on the western coast is rich with unique greenery	पश्चिमी घाट पर स्थित पेरियार वन्यजीव अभ्यारण्य का यह भूभाग अद्भुत हरितिमा से युक्त है
animals like elephant deer tiger short tailed monkey etc are found here	यहाँ हाथी हरिण बाघ लघु पुच्छ वानर आदि जीव जन्तु पाए जाते हैं
hordes of elephant grazing in the dense grass fields of the shore are seen while boating on the river	यहाँ नदी पर नौका विहार करते समय तट के घने घास के मैदानों में चरते हाथी के झुण्ड दिखाई देते हैं
we can reach the shila temple mangla devi temple situated at the center of the forest by trekking in thekkady forest	तेक्कडि वन में ट्रेकिंग के द्वारा जंगल के बीचोंबीच स्थित शिला मंदिर मंगला देवी मंदिर में पहुँच सकते हैं
thekkady is the most appropriate place to capture the pictures of wild elephants	जँगली हाथियों का फोटो उतारने के लिए तेक्कडि सबसे उपयुक्त स्थान है
two institutions in thekkady provide the lodging facility tiruvitankur kings summer bungalow of the lake palace and aranyanivas	तेक्कडि में दो संस्थाएँ सरोवर के तट पर ठहरने की सुविधा प्रदान करती हैं तिरुवितांकूर नरेशों का ग्रीष्मकालीन बंगला लेक पैलस और अरण्यनिवास
the lake palace is in a small island on the shore of aranyanivas lake	लेक पैलस अरण्यनिवास सरोवर के तट पर एक छोटे से द्वीप में है
now both are under the ownership of k	दोनों अब केटीडीसी के स्वामित्व में है
the mountainous place of trishanku mala is very charming	त्रिशंकु मला का पर्वतीय स्थान अत्यन्त रमणीय है
an enchanting charm is spread in trishanku mala	त्रिशंकु मला में मंत्रमुग्ध करने वाली सुषमा बिखरी है
viewing sunset from the top of hills in trishanku mala equals viewing the beauty directly	त्रिशंकु मला में पहाड़ियों के ऊपर से सूर्यास्त का दर्शन करना साक्षात् सौन्दर्य के दर्शन करने के समान है
but it needs courage to look down from the trishanku mala	किन्तु त्रिशंकु मला से नीचे देखने के लिए हिम्मत चाहिए
while enjoying the silky touch of the slow wind in trishanku mala it would be an indescribable experience to pass touring the forest areas	त्रिशंकु मला में मन्दमन्द झोंको के रेशम से स्पर्श का आनन्द उठाते हुए वन प्रदेशों के बीच भ्रमण करते हुए गुजरना अनिर्वचनीय अनुभव होगा
trishanku mala is located at a distance of k from peerumedu and half k from kuttikkanam	त्रिशंकु मला पीरुमेडु से किमी और कुट्टिक्कानम से आधा किमी की दूरी पर स्थित है
it is said that this hill became famous with the name of peerumala after the name of a sufi saint named peer muhammad	कहा जाता हैं कि पीरु मुहम्मद नामक सूफ़ी संत के नाम पर यह पहाड़ी पीरुमला नाम से प्रसिद्ध हो गई
this is a favorite place of the nomadics and trekking lovers	यह यायावरों और ट्रेकिंगशौकीनों का प्रिय स्थान है
kilimanoor palace is k away from thiruvananthapuram railway station	तिरुवनन्तपुरम रेलवे स्टेशन से किलिमानूर राजमहल किमी दूर है
from the thiruvananthapuram airport kilimanoor palace is k away	तिरुवनन्तपुरम अन्तर्राष्ट्रीय हवाई से किलिमानूर राजमहल अड्डा किमी दूर है
peerumala sufi mausoleum deewan bhawan the summer palatial mansion of the member of royal family are the things worth seeing	पीरुमला सूफ़ी मक़बरा दीवान भवन राज परिवार के सदस्यों का ग्रीष्मकालीन प्रासाद आदि देखने योग्य चीज़ें हैं
peerumala is k away from peerumedu and one k away from kuttikkanam	पीरुमला पीरुमेडु से किमी और कुट्टिक्कानम से एक किमी की दूरी पर है
peerumala is k away from kottayam railway station	पीरुमला कोट्टयम रेलवे स्टेशन से किमी दूर है
kochi international airport the nearest airport of peerumala is k away	पीरुमला का निकटतम एयरपोर्ट कोच्चि अन्तर्राष्ट्रीय हवाई अड्डा किमी दूर है
innumerous stories about vagaman are popular	वागामण् के बारे में असंख्य किस्सेकहानियाँ प्रचलित हैं
the matchless beauty of vagaman gives relish to both the eyes and the ears	वागामण् क्षेत्र का अनुपम सौन्दर्य आँखकान दोनों को रसास्वादन देता है
it appears that the glimpses of secret beauty has inadvertently appeared on the hills covering itself in greens	ऐसा प्रतीत होता है कि हरियाली ओढ़ कर लेटी पहाड़ियों पर निगूढ़ सौन्दर्य की झलकियाँ अनायास प्रकट हो गई है
the beauty of this region unveils gradually before the visitors of this greenery standing in vagaman	वागामण् में खड़े होकर इस हरिताभा का दर्शन करने वाले के समक्ष इस प्रदेश के सौन्दर्य का शनैशनै अनावरण होता है
there are such hills around vagaman where the tomb of muslim thangal the temple of hindu murugan christian church identified as cruce hill exist	वागामण के पास ऐसी पहाड़ियाँ हैं जहाँ मुस्लिम तंगल का मकबरा है हिन्दू मुरुकन का मंदिर है क्रूस पहाड़ नाम से पहचाना जाने वाला ईसाई गिरजा घर है
there is pine forest at the slopes in vagaman	वागामण् में ढलान पर चीड़ का वन है
the dairy farm under the church is also worth visiting	चर्च के अन्तर्गत डेयरी फार्म भी दर्शनीय है
vagaman is k away from peerumedu one can go to vagaman by bus	वागामण् पीरुमेडु से किमी है वागामण् बस से जा सकते हैं
kottayam the nearest railway station of vagaman is an a distance of k	वागामण् का निकटतम रेलवे स्टेशन कोट्टयम किमी की दूरी पर है
kochhi international airport the nearest airport of vagaman is at a distance of k	वागामण् का निकटतम एयरपोर्ट कोच्चि अन्तर्राष्ट्रीय हवाई अड्डा किमी की दूरी पर है
vattavada is a village located k east of munnar	मुन्नार से किमी पूर्व में स्थित वट्टावडा एक ग्राम है
vattavada is popular for its natural beauty and calm atmosphere	वट्टावडा अपने प्राकृतिक सौन्दर्य एवं शांत वातावरण के लिए प्रसिद्ध है
different places of tourist attractions in vattavada have not yet come forward completely	वट्टावडा में पर्यटकों को आकर्षित करने वाले विभिन्न स्थान अभी तक पूरी तरह सामने नहीं आए हैं
vattavada is worth visiting due to its vegetation parks in the same fashion as is munnar beautiful due to the tea gardens	जिस तरह मुन्नार चाय के बगानों के कारण मनोहर है उसी तरह वट्टावडा अपने वनस्पति उद्यानों के कारण दर्शनीय हैं
vattavada is also situated feet above the sea level still there is no unbearable cold in vattavada during winter days	वट्टावडा समुद्र तल से फीट की ऊँचाई पर स्थित भी है फिर वट्टावडा में जाड़े के दिनों में भी असह्य ठंड नहीं होती है
vegetables are farmed in vattavada after leveling the ascents of mountain	वट्टावडा में पहाड़ की चढ़ाइयों को समतल बनाकर साग सब्जियों की खेती की जाती है
different kinds of butterflies and birds are found in vattavada	वट्टावडा में विभिन्न प्रकार की तितलियाँ और पक्षी मिलते हैं
the journey to kodaikanal top station mattuppetti kantallur meesapulimala can only be done from vattavada	वट्टावडा से ही कोडाईकेनाल टोप स्टेशन माट्टुप्पेट्टि कान्तल्लूर मीशप्पुलिमला तक की वन यात्रा की जा सकती है
for this the journey can also be done by jeep or motorcycle	इसके लिए जीप या मोटर साइकिल से भी यात्ना की जा सकती है
services of private agencies are also available for erecting tent in vattavada and the jungle	वट्टावडा तथा जंगल में तम्बू लगाने के लिए प्राइवेट एजेन्सियों की सेवाएँ उपलब्ध हैं
vattavada is k far from munnar by road	वट्टावडा मुन्नार सड़क से किमी दूर है
the nearest railway station ernakulam junction is k away from vattavada	वट्टावडा से किमी दूर निकटतम रेलवे स्टेशन एरणाकुलम जंक्शन है
kochi international airport is k away from vattavada	कोच्चि अन्तर्राष्ट्रीय हवाई अड्डा वट्टावडा से किमी दूर है
aralam is a wildlife sanctuary	आरळम वन्यजीव अभ्यारण्य है
aralam is spread in an expanse of square k on the slopes of sahyadri	आरळम सह्याद्रि की ढलान पर वर्ग किमी विस्तार में फैला हुआ है
deer elephants bisons wild boars etcetera roam commonly in aralam	आरळम में हीरण हाथी बाइसन जंगली सुअर आदि सामान्य रूप से विचरते हैं
leopard wild cat and different types of squirrels etcetera can be seen sometimes	चीता जंगली बिल्ली तथा विभिन्न तरह की गिलहरियाँ आदि कभीकभार दिखाई पड़ सकती हैं
spread in hectares aralam farm is located near it	हेक्टेयर विस्तृत आरलम फार्म इसके करीब स्थित है
aralam is situated k away from thalassery and k away from kannur	आरलम तलश्शेरी से किमी और कण्णूर टाउन से किमी स्थित है
thalassery is the nearest railway station from aralam	आरलम से निकटतम रेलवे स्टेशन तलश्शेरी है
the nearest airport from aralam karipur international airport is k away from thalassery	आरलम से निकटतम एयरपोर्ट करिप्पूर हवाई अड्डा तलश्शेरी से किमी है
the lake known as kavvayi in this part of north kerala spreads matchless grandeur	उत्तरी केरल के इस भाग में कव्वायि नाम से जानी जाने वाली झील अनुपम शोभा बिखेरती है
canals like kavvayi and kankol vannathichal kuppithodu kuniyan etcetera form into lake	कव्वायि और कांकोल वण्णात्तिच्चाल कुप्पित्तोडु कुनियन आदि नहरें झील का रूप ग्रहण करती हैं
kavvayi lake is square k long	कव्वायि झील वर्ग किमी लम्बी है
for complete enjoyment of the beauty of the lake travel should be done by boat in the kottikottapuram way	झील के सौन्दर्य के परिपूर्ण आनन्द के लिए कोट्टिकोट्टप्पुरम मार्ग में नौका द्वारा यात्रा की जानी चाहिए
nearest to the kavvayi lake the payyannur railway station is k away	कव्वायि झील से निकटतम पय्यन्नूर रेलवे स्टेशन किमी दूर है
karipur international airport kannur is the nearest airport of kavvayi lake at a distance of k	किमी स्थित कव्वायि झील का निकटतम एयरपोर्ट करिप्पूर अन्तर्राष्ट्रीय हवाई अड्डा कण्णूर है
sheltered in pazhayangadi of kannur madayipara is rich with biodiversity and historical tradition	कण्णूर के पष़यंगाडि में बसा माडायिप्पारा जैवविविधता एवं ऐतिहासिक परम्परा से समृद्ध है
ezhimala was the capital of kolattunad kings	एष़िमला कोलत्तुनाड राजाओं की राजधानी थी
coronation of kolattunad kings used to complete in madayipara from th century till th century	वीं शताब्दी से वीं शताब्दी तक कोलत्तुनाडु नरेशों का अभिषेक माडायिप्पारा में ही सम्पन्न होता था
the ruins of the old castle is in the southern valleys of the hill	पहाड़ी की दक्षिणी घाटियों में पुराने किले का खण्डहर है
a pond is here which has the shape of long handled mirror	यहाँ एक तालाब है जो लम्बी हत्थी वाले दर्पण की आकृति का है
it is said that the construction of the pond was got done by the jews	कहते हैं माडायिप्पारा के तालाब का निर्माण यहूदियों ने कराया था
other attractions of madayipara are the shaivite temple the pond of the temple spread over an acre and madayi kavu the sacred place in the dense forests	माडायिप्पारा के अन्य आकर्षण हैं शैव मंदिर एक एकड़ में विस्तृत मंदिर का तालाब और माडायिक्कावु घने जंगलों में पवित्र स्थान
the organization of madayipuram festival is related to madayi kavu	माडायिप्पूरम उत्सव का आयोजन माडायिक्कावु से सम्बद्ध है
other attractions of this hill are fruits and flowers of different species tubers of species hundreds of the herb species meat eater vegetations birds of different species etcetera	इस पहाड़ी के अन्य आकर्षण हैं विभिन्न प्रजातियों के फल और फूल प्रजातियों के मूलकन्द जड़ीबूटियों की सैकड़ों प्रजातियाँ मांस भोजी वनस्पतियाँ भिन्न प्रजातियों के पक्षी आदि
the biggest butterflies of the world atlas butterflies use to come to madayipara for getting hospitality	दुनिया की सबसे बड़ी तितली अट्लस तितली भी माडायिप्पारा में आतिथ्य पाने आया करती हैं
considering the historical and zoological specialties of madayipara area the state government has prepared special plans for their conservation	माडायिप्पारा क्षेत्र की ऐतिहासिक एवं जैव वैज्ञानिक विशेषताओं को ध्यान में रखते हुए राज्य सरकार ने इनके संरक्षण के लिए विशेष योजनाएँ तैयार की हैं
the nearest railway station of madayipara pazhayangadi is at a distance of k	माडायिप्पारा से निकटतम रेलवे स्टेशन पष़यंगाडि किमी की दूरी पर है
the nearest airport from madayipara karipur international airport is at a distance of k	माडायिप्पारा से निकटतम एयरपोर्ट करिप्पूर अन्तर्राष्ट्रीय हवाई अड्डा किमी की दूरी पर है
malayala kalagramam is a training center for artists	मलयाल कलाग्रामम कलाकारों के लिए एक प्रशिक्षणालय है
the opportunity to learn several arts and to practice them is provided in malayala kalagramam	मलयाल कलाग्रामम में अनेक कलाएँ सीखने तथा उनका अभ्यास करने का अवसर प्रदान किया जाता है
full time training is provided in picture drawing sculpture song dance ceramics etc at malayala kalagramam	मलयाल कलाग्रामम में चित्र रचना शिल्प कला संगीत नृत्य चिकनी मिट्टी से बर्तन बनाने की कला आदि में पूर्णकालिक प्रशिक्षण दिया जाता है
the classes of yoga and sanskrit etc are also run in malayala kalagramam	मलयाल कलाग्रामम में योग और संस्कृत आदि की कक्षाएँ भी चलाई जाती हैं
seminars on the subjects of the culture and history of kerala are organized in malayala kalagramam	मलयाल कलाग्रामम में केरल की संस्कृति एवं इतिहास विषयों पर संगोष्ठियाँ आयोजित की जाती हैं
the library of kalagramam is excellent	कलाग्रामम का ग्रन्थालय उत्तम है
spending a day with the teacher and the students of malayala kalagramam gives a new experience	मलयाल कलाग्रामम के अध्यापक तथा विद्यार्थियों के साथ एक दिन व्यतीत करना एक नया अनुभव देता है
malayala kalagramam new mahi is situated at a distance of k from kannur	मलयाल कलाग्रामम न्यू माही कण्णूर से किमी की दूरी पर स्थित है
mahi is the nearest railway station of malayala kalagramam	मलयाल कलाग्रामम से निकटतम रेलवे स्टेशन माही है
the nearest airport karipur international airport is at a distance of k from malayala kalagramam	मलयाल कलाग्रामम से निकटतम एयरपोर्ट करिप्पूर अन्तर्राष्ट्रीय हवाई अड्डा किमी की दूरी पर है
kanimangalam is famous for sculptures and the lamps made of brass	कणिमंगलम पीतल से बने शिल्पों और दीपों के लिए प्रसिद्ध है
kanimangalam is near payyannur	कणिमंगलम पय्यन्नूर के पास है
muzhappilangad beach is one of the unique drivein coasts of kerala	मुष़प्पिलंगाडु बीच केरल के अनुपम ड्राइव इन समुद्रतटों में एक है
the feeling of journey by a vehicle on the coast of about k long muzhappilangad beach is extraordinary	लगभग किमी लम्बे मुष़प्पिलंगाडु बीच के समुद्र तट पर वाहन द्वारा यात्रा करने की अनुभूति विलक्षणीय है
several gigantic rocks are standing stopping the encroachment of high waves of the sea at muzhappilangad beach	मुष़प्पिलंगाडु बीच पर समुद्र की उत्ताल तरंगों के अतिक्रमण को रोकते हुए कई विशाल चट्टानें खड़ी हैं
many natural pools have formed due to these rocks	इन चट्टानों के कारण अनेक नैसर्गिक कुण्ड बन गए
that is why muzhappilangad beach is considered as the heaven of the swimmers	यही कारण है कि मुष़प्पिलंगाडु बीच तैराकियों का स्वर्ग माना जाता है
the coconut trees standing parallel to the coast cast shadow on the coast	तट के समानांतर खड़े नारियल के पेड़ तट पर छाया प्रदान करते हैं
muzhappilangad beach is k far from kannur and k away from thalassery	मुष़प्पिलंगाडु बीच कण्णूर से किमी तथा तलश्शेरी से किमी की दूरी पर है
kannur the nearest railway station of muzhappilangad beach is k away	मुष़प्पिलंगाडु बीच का निकटतम रेलवे स्टेशन कण्णूर किमी दूर है
mangalore the nearest airport of muzhappilangad beach is k away while karipur international airport is k away	मुष़प्पिलंगाडु बीच से निकटतम एयरपोर्ट मंगलूर किमी दूर है जबकि करिप्पूर अन्तर्राष्ट्रीय हवाई अड्डा किमी दूर है
payyambalam seacoast is appropriate for spending evening with calm	पय्यांबलम समुद्रतट स्थान शान्तिपूर्वक संध्या बिताने के लिए उपयुक्त है
till some time ago payyambalam seabank was the center of picnic for the local public	कुछ समय पहले तक पय्यांबलम समुद्रतट स्थानीय लोगों के पिकनिक का केन्द्र था
gradually the arrival of tourists on payyambalam seabank is increasing	धीरेधीरे पय्यांबलम समुद्रतट पर पर्यटकों का आगमन बढ़ता जा रहा है
kannur the nearest railway station from payyambalam seacoast is at a distance of k	पय्यांबलम समुद्रतट से निकटतम रेलवे स्टेशन कण्णूर किमी की दूरी पर स्थित है
the nearest airport from payyambalam the karipur international airport is at a distance of k	पय्यांबलम समुद्रतट से निकटतम एयरपोर्ट करिप्पूर अन्तर्राष्ट्रीय हवाई अड्डा किमी दूर है
built by portuguese viceroy francisco de almeida in	पुर्तगाली वाइसराय फ्रान्सिस्को डी अल्मेड द्वारा में बनवाया गया
the fort made of red stones is in triangular shape	लाल पत्थरों से बना यह किला त्रिकोणात्मक आकृति का है
the dutch had captured the saint angelo fort in and sold to ali king of kannur	सन् में सैंट आंचलो किले पर डचों ने कब्जा कर लिया था और कण्णूर के अली राजा को बेच दिया था
in the british took saint angelo fort under their own dominion and made it the main center of the malabar soldiers	सन् में ब्रिटिशों ने सैंट आंचलो किला अपने अधीन कर लिया और मालाबार के सैनिकों का प्रमुख केन्द्र बना लिया
today the st angelo fort is a conserved monument under the department of archaeology	आज सैंट आंचलो किला पुरातत्व विभाग के अन्तर्गत संरक्षित स्मारक है
a sea wall has been built outside the st angelo fort	सैंट आंचलो किले के बाहर समुद्री भित्ति बनाई गई है
the sea wall saves st angelo fort from the beatings of the waves	समुद्री भित्ति सैंट आंचलो किले को लहरों की मार से बचाती है
mappila bay fish collection harbor dharmadam island etcetera can be seen while standing at the st angelo fort	सैंट आंचलो किले पर खड़े होकर माप्पिला बे मत्स्य संग्रहण बन्दरगाह धर्मडम द्वीप आदि देखे जा सकते हैं
mappila bay harbour is a boon of nature	मॉप्पिला बे बन्दरगाह प्रकृति का वरदान है
mappila bay harbour has been modernized under the indonorwegian project	मॉप्पिला बे बन्दरगाह का इन्डो नोरवीजियन परियोजना के अन्तर्गत आधुनिकीकरण हुआ है
dharmdam island whose expanse is acre is only metre away from seashore	धर्मडम द्वीप जिसका विस्तार एकड़ है समुद्र तट से केवल मीटर दूर है
kannur the nearest railway station from st angelo fort is at a distance of k	सैंट आंचलो किला से निकटतम रेलवे स्टेशन कण्णूर किमी की दूरी पर है
the nearest airport from saint angelo karipur international airport is k away	सैंट आंचलो किला से निकटतम एयरपोर्ट करिप्पूर अन्तर्राष्ट्रीय हवाई अड्डा किमी दूर है
thalassery has gained special place in the history of kerala	तलश्शेरी का केरल के इतिहास में विशेष स्थान प्राप्त है
continuous connection with overseas commercial tradition mature cricket tradition the tradition of circus etcetera are included among the prosperous heritages of thalassery	तलश्शेरी की समृद्ध विरासतों में विदेशों से रहे निरंतर संपर्क व्यापारिक परंपरा प्रौढ क्रिकेट परंपरा सर्कस की परंपरा आदि शामिल हैं
the portuguese and the dutch had tried to capture thalassery	पुर्तगालियों और डचों ने तलश्शेरी पर अधिकार जमाने की चेष्टा की थी
the british army chief arthur miller who had come to capture the pazhassi king stayed in thalassery for a long time	ब्रिटिश सेनापति आर्थर मिल्लर जो पष़श्शि राजा को अधीन करने आया था तलश्शेरी में लम्बे समय तक रहा
it was arthur millar who introduced cricket to thalassery	आर्थर मिल्लर ने ही तलश्शेरी को क्रिकेट के खेल को परिचित करवाया
gradually the local public learned the game from the british soldiers	धीरेधीरे स्थानीय लोगों ने ब्रिटिश सैनिकों से यह खेल सीखा
big families like musa mampalli etcetera encouraged cricket	मूसा मांपळ्ळि आदि बड़ेबड़े परिवारों ने क्रिकेट को प्रोत्साहन दिया
there was also a time when cricket clubs used to come to play from britain and sri lanka in thalassery	एक ऐसा समय भी था जब तलश्शेरी में ब्रिटेन और श्रीलंका से खेलने के लिए क्रिकेट क्लब आते थे
thus thalassery could be given a place among those leading places where the cricket game was organized first	इस प्रकार तलश्शेरी को उन स्थानों में अग्रगणनीय स्थान दिया जा सकता है जहाँ क्रिकेट खेल का आयोजन सर्वप्रथम हुआ था
thalassery has an important contribution in the tradition of circus also	सर्कस परंपरा में भी तलश्शेरी का महत्वपूर्ण योगदान है
the circus artists of thalassery have earned fame at the international level by presenting the best presentation	तलश्शेरी के सर्कस कलाकारों ने सर्वोत्तम प्रदर्शन प्रस्तुत कर अंन्तर्राष्ट्रीय स्तर पर यश अर्जित किया
among the important circus stars of india udati bijali is a child of thalassery	भारत के महत्वपूर्ण सर्कस सितारों में एक उड़ती बिजली तलश्शेरी की संतान हैं
the people of thalassery are experts in preparing sweets and experimenting with new sweets	मिठाइयाँ बनाने और नईनई मिठाइयों का प्रयोग कर देखने में तलश्शेरी के लोग सिद्धहस्त हैं
mampalli is prominent bakery family of kerala	केरल के प्रमुख बेकरी परिवार मांपळ्ळि है
bakery family has years of experience in the field of bakery	बेकरी परिवार का बेकरी क्षेत्र में वर्ष का अनुभव है
mampalli family started a new revolution by establishing bakeries from one corner to the other corner of kerala	मांपळ्ळि परिवार ने केरल के एक कोने से दूसरे कोने तक बेकरी की स्थापना करके एक नई क्रान्ति चलाई
bakeries of mampalli are standing with grandeur at some places of kerala even today	आज भी केरल में कुछ स्थानों पर मांपळ्ळि वालों की बेकरियाँ शान से खड़ी हैं
the logan street of thalassery is another attraction	तलश्शेरी की लोगन स्ट्रीट गली एक अन्य आकर्षण है
this place is famous for sweets noodles clothes and biryani	यह स्थान मिठाइयाँ सेवईयाँ कपड़े और बिरियानी के लिए प्रसिद्ध है
the paris hotel situated in logan street is famous for biryani	लोगन स्ट्रीट में स्थित पैरिस होटल बिरियानी के लिए मशहूर है
other attractions of thalassery are year old brannan college the residence of herman gundert which is known as illikkunu bungalow and thalassery fort etc	तलश्शेरी के दूसरे आकर्षण हैं वर्ष पुराना ब्रन्नन कॉलेज हेरमन गुण्डेर्ट का निवासस्थान जो इल्लिक्कुन्नु बँगला नाम से जाना जाता है तथा तलश्शेरी किला आदि
the seacoast of north goa beginning from fort aguada is about k long	फोर्ट अगॉडा से शुरू होने वाला नॉर्थ गोवा का समुद्र तट लगभग किमी लंबा है
there is a railway station in thalassery	तलश्शेरी में एक रेलवे स्टेशन है
the nearest airport from thalassery is karipur international airport	तलश्शेरी से निकटतम एयरपोर्ट करिप्पूर अन्तर्राष्ट्रीय हवाई अड्डा है
todikkulam shaiva temple is very old	तोडिक्कुळम शैव मंदिर अत्यंत पुराना है
according to some people the four cornered two storey temple of todikkulam is two thousand years old	कुछ लोगों के अनुसार तोडिक्कुळम का दुमंजिला चौकोना मंदिर दो हज़ार वर्ष पुराना है
special wall picture is characteristic of this temple	विशिष्ट भित्तिचित्र इस मंदिर की विशेषता है
there are about wall paintings drawn in lines on a width of square metres on the walls of the cella in todikkulam	तोडिक्कुळम में श्रीमंदिर गर्भगृह की दीवारों पर पंक्तियों में वर्ग चौड़ाई पर चित्रित लगभग भित्तिचित्र हैं
the main subjects of these paintings are rukmani swayamvar rawan wadh etc	इन चित्रों के प्रमुख विषय है रुक्मिणी स्वयंवर रावणवध आदि
along with this there are several other pictures which represent the village life and whose period is th th century	साथ ही दूसरे अनेक चित्र हैं जो ग्रामीण जीवन का प्रतिपादन करते हैं और जिनका काल वीं वीं शताब्दी हैं
the nearest railway station from todikkulam thalassery is at a distance of k	तोडिक्कुळम से निकटतम रेलवे स्टेशन तलश्शेरी किमी की दूरी पर है
the nearest airport from todikkulam karipur international airport is k away	तोडिक्कुळम से निकटतम एयरपोर्ट करिप्पूर अन्तर्राष्ट्रीय हवाई अड्डा किमी दूर है
the extraordinary and excellent religious functions and customs are conducted in the parassinikkadavu sree muthappan temple	परश्शिनिक्कटवु श्रीमुत्तप्पन मंदिर में अपूर्व एवं अनुपम धार्मिक अनुष्ठान एवं आचार संपन्न होते हैं
people of different religions castes come to the parassinikkadavu sree muthappan temple for worship	परश्शिनिक्कटवु श्रीमुत्तप्पन मंदिर में विभिन्न धर्मोंजातियों के लोग उपासना के लिए आते हैं
parassinikkadavu sree muthappan temple resonates the thought of vasudhaivakutumbakam	परश्शिनिक्कटवु श्रीमुत्तप्पन मंदिर वसुधैवकुटुम्बकम् विचार का पालन करता है
devotee following any religion caste can enter the parassinikkadavu sree muthappan temple	परश्शिनिक्कटवु श्रीमुत्तप्पन में किसी भी जातिधर्म को मानने वाला भक्त प्रवेश कर सकता है
muthappan temple is situated on the banks of the valapattanam river	मुत्तप्पन मंदिर वळपट्टणम नदी तट पर स्थित है
muthappan temple is k far from kannur	मुत्तप्पन मंदिर कण्णूर से किमी दूर है
a folk dance called theyyam can also be seen in muthappan	मुत्तप्पन में तेय्यम नामक लोकनृत्य भी देखा जा सकता है
there is a myth behind the foundation of the temple presented	प्रस्तुत मंदिर की स्थापना के पीछे एक किंवदन्ती है
a boy appeared here suddenly	यहाँ एक बालक अकस्मात प्रकट हुआ
after some miraculous incidents he disappeared	कुछ चमत्कारपूर्ण घटनाओं के उपरान्त लुप्त हो गया था
after disappearance of the boy the public felt the divine realization there	बालक के लुप्त होने के बाद भगवत् अनुभूति लोगों को वहाँ हुई
as a result this temple was made	परिणाम स्वरूप यह मंदिर बनवाया गया था
east india company had kept constant relation with thalassery since	सन् से ईस्ट इंडिया कंपनी तलश्शेरी के साथ लगातार सम्बंध बनाए रखती आई थी
in the company built a fort in thalassery	में कंपनी ने तलश्शेरी में एक किला बनवाया





















































































































































































































